CCCAGCGCCGAATGCATACA -> CCAGCGCCGAATGCATACAA
AAGCATGCTGAGTGCGGTGC -> AGCATGCTGAGTGCGGTGCA
TTGGAATCGCACTGTCTCTG -> TGGAATCGCACTGTCTCTGT
GTTACGGCCTAGTTGGAGGT -> TTACGGCCTAGTTGGAGGTG
CTCGAATCGACGTTGGGCAA -> TCGAATCGACGTTGGGCAAG
CATTCTGAGATGTAGTGCCC -> ATTCTGAGATGTAGTGCCCT
ACACGTCTGACGTCAACTTA -> CACGTCTGACGTCAACTTAA
ATCGACGTTGGGCAAGTACC -> TCGACGTTGGGCAAGTACCC
ATGCGCGATGAAGCATAAGC -> TGCGCGATGAAGCATAAGCG
ATAGCACCCTAATCGGTGAA -> TAGCACCCTAATCGGTGAAT
TGTACTCAGATCCTTAAAGC -> GTACTCAGATCCTTAAAGCT
CGTCTGACGTCAACTTAAGG -> GTCTGACGTCAACTTAAGGA
AGCGCCGAATGCATACAATG -> GCGCCGAATGCATACAATGA
ATAACATTAAACCCCAGCTC -> TAACATTAAACCCCAGCTCC
ATTGTATCGTATAAGTTAGC -> TTGTATCGTATAAGTTAGCC
ACGGGCCGCGCAGCCCAGGA -> CGGGCCGCGCAGCCCAGGAA
CAATCCTATTCCGCAGCGAC -> AATCCTATTCCGCAGCGACC
CATAACATTAAACCCCAGCT -> ATAACATTAAACCCCAGCTC
TTCCGCAGCGACCAAGAGCT -> TCCGCAGCGACCAAGAGCTA
TCCGCAGCGACCAAGAGCTA -> CCGCAGCGACCAAGAGCTAT
AACGGCAAGTAGGCTGGCCC -> ACGGCAAGTAGGCTGGCCCC
TCGTGAGATATTGCGCCGAC -> CGTGAGATATTGCGCCGACA
TAACATTAAACCCCAGCTCC -> AACATTAAACCCCAGCTCCG
AGTACCCCCTAACAACCGTA -> GTACCCCCTAACAACCGTAA
CACGTCTGACGTCAACTTAA -> ACGTCTGACGTCAACTTAAG
CCAGGTTGTCCCGAGGTATG -> CAGGTTGTCCCGAGGTATGG
TATTCCGCAGCGACCAAGAG -> ATTCCGCAGCGACCAAGAGC
AGAGTTCAATGAGCCGCCTG -> GAGTTCAATGAGCCGCCTGG
ACTTTAGGTTTTGAGCCTAG -> CTTTAGGTTTTGAGCCTAGA
CTCCAGGTTGTCCCGAGGTA -> TCCAGGTTGTCCCGAGGTAT
ACACTACCTGTAGGCGTCGG -> CACTACCTGTAGGCGTCGGA
GTTACGCGACAGAGTTCAAT -> TTACGCGACAGAGTTCAATG
GAACGTAAAAAACAGTCTTT -> AACGTAAAAAACAGTCTTTA
TACTAAGGTTCCAGCCCAGC -> ACTAAGGTTCCAGCCCAGCG
GCTGAGTGCGGTGCACGTTT -> CTGAGTGCGGTGCACGTTTC
GTGCACGTTTCCCCTACGTG -> TGCACGTTTCCCCTACGTGA
TTAGATGATGTGGTCTCACA -> TAGATGATGTGGTCTCACAT
TACAATGAACTGACTATCAT -> ACAATGAACTGACTATCATA
TCCCAATCCTATTCCGCAGC -> CCCAATCCTATTCCGCAGCG
GCGGTTGGGGCACGGGGTCC -> CGGTTGGGGCACGGGGTCCG
TAAAAAACAGTCTTTAGATG -> AAAAAACAGTCTTTAGATGA
GCGTACGACCATATAGTCAT -> CGTACGACCATATAGTCATC
ACTATCATAACATTAAACCC -> CTATCATAACATTAAACCCC
CAAGTACCCCCTAACAACCG -> AAGTACCCCCTAACAACCGT
GCGTTACCCCAAACGCCATA -> CGTTACCCCAAACGCCATAC
CTTGGGCTCCAGGTTGTCCC -> TTGGGCTCCAGGTTGTCCCG
GAGGTATGGCTTCCACACGT -> AGGTATGGCTTCCACACGTC
GGGCCGCGCAGCCCAGGAAC -> GGCCGCGCAGCCCAGGAACA
ACCCGCGTATAGCGGGCGGG -> CCCGCGTATAGCGGGCGGGC
TGCACCCGACACTTTGCCTT -> GCACCCGACACTTTGCCTTT
CCTCGGCCCACGTGGGCCCC -> CTCGGCCCACGTGGGCCCCC
CGTACTAAGGTTCCAGCCCA -> GTACTAAGGTTCCAGCCCAG
CTGTCTCTGTACTCAGATCC -> TGTCTCTGTACTCAGATCCT
GCACCCTAATCGGTGAATTG -> CACCCTAATCGGTGAATTGT
TACTCAGATCCTTAAAGCTT -> ACTCAGATCCTTAAAGCTTG
TCCATCTGATGGCCCATCCT -> CCATCTGATGGCCCATCCTT
CCCGCGTATAGCGGGCGGGC -> CCGCGTATAGCGGGCGGGCT
CCAGCCCAGCGCCGAATGCA -> CAGCCCAGCGCCGAATGCAT
CCTGAAGCAACAGCGAGCTA -> CTGAAGCAACAGCGAGCTAC
ATGCTCCGAACGTAAAAAAC -> TGCTCCGAACGTAAAAAACA
CATCTTGCCGCGTCAAAGGA -> ATCTTGCCGCGTCAAAGGAC
CTAGTTGGAGGTGCTCCACC -> TAGTTGGAGGTGCTCCACCC
CTGCTGCATCTTGCCGCGTC -> TGCTGCATCTTGCCGCGTCA
TTGTATCGTATAAGTTAGCC -> TGTATCGTATAAGTTAGCCC
GACTCACGTCGATATTTTGA -> ACTCACGTCGATATTTTGAG
GAATCGACGTTGGGCAAGTA -> AATCGACGTTGGGCAAGTAC
TTCAATGAGCCGCCTGGCAA -> TCAATGAGCCGCCTGGCAAC
CCACACGTCTGACGTCAACT -> CACACGTCTGACGTCAACTT
GCCCACGTGGGCCCCCTGAA -> CCCACGTGGGCCCCCTGAAG
CTCCACCCGTACGTCGTACT -> TCCACCCGTACGTCGTACTG
GGGCCCCCTGAAGCAACAGC -> GGCCCCCTGAAGCAACAGCG
CGCAGCGACCAAGAGCTATG -> GCAGCGACCAAGAGCTATGC
CCTTGTGACGGCCGGCGTTA -> CTTGTGACGGCCGGCGTTAC
ATGAACTGACTATCATAACA -> TGAACTGACTATCATAACAT
AGCGAGCTACTCCTCCAAGC -> GCGAGCTACTCCTCCAAGCA
TGGCCCCGTGCTTCCTCGTG -> GGCCCCGTGCTTCCTCGTGA
CAATCCAATCGCGGTTGGAA -> AATCCAATCGCGGTTGGAAT
CCCTCGAGAGATCACGTTTA -> CCTCGAGAGATCACGTTTAC
TGCGCCGACACCCGCGTATA -> GCGCCGACACCCGCGTATAG
GCGAGCTACTCCTCCAAGCA -> CGAGCTACTCCTCCAAGCAT
TCCGTAGCAACATCCCAATC -> CCGTAGCAACATCCCAATCC
GGCTTGGGCTCCAGGTTGTC -> GCTTGGGCTCCAGGTTGTCC
GAACTTTAGGTTTTGAGCCT -> AACTTTAGGTTTTGAGCCTA
GCACCCGACACTTTGCCTTT -> CACCCGACACTTTGCCTTTC
GCCGACACCCGCGTATAGCG -> CCGACACCCGCGTATAGCGG
AGCTTGCACCCGACACTTTG -> GCTTGCACCCGACACTTTGC
ACCCGACACTTTGCCTTTCC -> CCCGACACTTTGCCTTTCCC
GGCTTCCACACGTCTGACGT -> GCTTCCACACGTCTGACGTC
CAACTCGAATCGACGTTGGG -> AACTCGAATCGACGTTGGGC
GTCCCGAGGTATGGCTTCCA -> TCCCGAGGTATGGCTTCCAC
GCCTTATTGTATCGTATAAG -> CCTTATTGTATCGTATAAGT
GGTGCCGACCCGCTATAACA -> GTGCCGACCCGCTATAACAG
CTCCAAGCATGCTGAGTGCG -> TCCAAGCATGCTGAGTGCGG
TATATGGGATTTCATAGCAC -> ATATGGGATTTCATAGCACC
AGATCCTTAAAGCTTGCACC -> GATCCTTAAAGCTTGCACCC
CCCTGAAGCAACAGCGAGCT -> CCTGAAGCAACAGCGAGCTA
GAGATATTGCGCCGACACCC -> AGATATTGCGCCGACACCCG
GTATATGGGATTTCATAGCA -> TATATGGGATTTCATAGCAC
CACGCCTTATTGTATCGTAT -> ACGCCTTATTGTATCGTATA
CAATGAACTGACTATCATAA -> AATGAACTGACTATCATAAC
AATGCGGTCTAGTGAAGAAC -> ATGCGGTCTAGTGAAGAACT
AACTCATAGCGTACGACCAT -> ACTCATAGCGTACGACCATA
TGAACTGACTATCATAACAT -> GAACTGACTATCATAACATT
TTTAGATGATGTGGTCTCAC -> TTAGATGATGTGGTCTCACA
CCACGTGGGCCCCCTGAAGC -> CACGTGGGCCCCCTGAAGCA
TGCACGCCTTATTGTATCGT -> GCACGCCTTATTGTATCGTA
AGTTCAATGAGCCGCCTGGC -> GTTCAATGAGCCGCCTGGCA
TCCTATTCCGCAGCGACCAA -> CCTATTCCGCAGCGACCAAG
GCACGGGGTCCGTCCTATCA -> CACGGGGTCCGTCCTATCAT
CATGCGCGATGAAGCATAAG -> ATGCGCGATGAAGCATAAGC
TAGCACCCTAATCGGTGAAT -> AGCACCCTAATCGGTGAATT
GACATTAAACGGCAAGTAGG -> ACATTAAACGGCAAGTAGGC
TCCCCTACGTGAGGTGCCGA -> CCCCTACGTGAGGTGCCGAC
TACTGTTACGCGACAGAGTT -> ACTGTTACGCGACAGAGTTC
ACGCCAGACTCACGTCGATA -> CGCCAGACTCACGTCGATAT
GACCAAGAGCTATGCTCCGA -> ACCAAGAGCTATGCTCCGAA
TACCGGGTGCACGCCTTATT -> ACCGGGTGCACGCCTTATTG
CCCCTACGTGAGGTGCCGAC -> CCCTACGTGAGGTGCCGACC
AGGTTCCAGCCCAGCGCCGA -> GGTTCCAGCCCAGCGCCGAA
GCAAGTACCCCCTAACAACC -> CAAGTACCCCCTAACAACCG
GCGTATAGCGGGCGGGCTCC -> CGTATAGCGGGCGGGCTCCG
CCAGCTCCGTAGCAACATCC -> CAGCTCCGTAGCAACATCCC
TCCAAGCATGCTGAGTGCGG -> CCAAGCATGCTGAGTGCGGT
CGCCTGGCAACTCGAATCGA -> GCCTGGCAACTCGAATCGAC
GCTACTCCTCCAAGCATGCT -> CTACTCCTCCAAGCATGCTG
GTCCGTCCTATCATCGTATA -> TCCGTCCTATCATCGTATAT
CGCGTCAAAGGACGGGCCGC -> GCGTCAAAGGACGGGCCGCG
TTCCCCTACGTGAGGTGCCG -> TCCCCTACGTGAGGTGCCGA
ACGTCAACTTAAGGAGCGAC -> CGTCAACTTAAGGAGCGACG
ATTCCGCAGCGACCAAGAGC -> TTCCGCAGCGACCAAGAGCT
CTGACTATCATAACATTAAA -> TGACTATCATAACATTAAAC
CATCTGATGGCCCATCCTTG -> ATCTGATGGCCCATCCTTGT
GGGCTCCAGGTTGTCCCGAG -> GGCTCCAGGTTGTCCCGAGG
TGAATTGTCTAGGACATTAA -> GAATTGTCTAGGACATTAAA
TACCCCAAACGCCATACGCC -> ACCCCAAACGCCATACGCCA
TTACGCGACAGAGTTCAATG -> TACGCGACAGAGTTCAATGA
CCTAACCTACCGGGTGCACG -> CTAACCTACCGGGTGCACGC
CTATGCTCCGAACGTAAAAA -> TATGCTCCGAACGTAAAAAA
CGGCGTTACCCCAAACGCCA -> GGCGTTACCCCAAACGCCAT
CAATGAGCCGCCTGGCAACT -> AATGAGCCGCCTGGCAACTC
GCCGCGCAGCCCAGGAACAC -> CCGCGCAGCCCAGGAACACT
CCTAACAACCGTAACTCATA -> CTAACAACCGTAACTCATAG
GCGGGCTCCGTCCATCTGAT -> CGGGCTCCGTCCATCTGATG
CGGTGCACGTTTCCCCTACG -> GGTGCACGTTTCCCCTACGT
AAAAAACAGTCTTTAGATGA -> AAAAACAGTCTTTAGATGAT
TTTGAGCCTAGAGCTGCTGC -> TTGAGCCTAGAGCTGCTGCA
CACCCGTACGTCGTACTGTT -> ACCCGTACGTCGTACTGTTA
CGTGAGGTGCCGACCCGCTA -> GTGAGGTGCCGACCCGCTAT
TGAGTGCGGTGCACGTTTCC -> GAGTGCGGTGCACGTTTCCC
TTGCACCCGACACTTTGCCT -> TGCACCCGACACTTTGCCTT
GTACTGTTACGCGACAGAGT -> TACTGTTACGCGACAGAGTT
CGGGCGGGCTCCGTCCATCT -> GGGCGGGCTCCGTCCATCTG
TTGGGCAAGTACCCCCTAAC -> TGGGCAAGTACCCCCTAACA
TACTCCTCCAAGCATGCTGA -> ACTCCTCCAAGCATGCTGAG
GGCAACTCGAATCGACGTTG -> GCAACTCGAATCGACGTTGG
CCCTAATCGGTGAATTGTCT -> CCTAATCGGTGAATTGTCTA
TCATCAATCCAATCGCGGTT -> CATCAATCCAATCGCGGTTG
CTGACGTCAACTTAAGGAGC -> TGACGTCAACTTAAGGAGCG
AAGCATAAGCGTATAGCGGT -> AGCATAAGCGTATAGCGGTT
GTGCTCCACCCGTACGTCGT -> TGCTCCACCCGTACGTCGTA
AGGAACACTACCTGTAGGCG -> GGAACACTACCTGTAGGCGT
ACTCATAGCGTACGACCATA -> CTCATAGCGTACGACCATAT
GCGGTCTAGTGAAGAACTTT -> CGGTCTAGTGAAGAACTTTA
ATCGTATAAGTTAGCCCCCT -> TCGTATAAGTTAGCCCCCTC
TCCACACGTCTGACGTCAAC -> CCACACGTCTGACGTCAACT
CGTACGTCGTACTGTTACGC -> GTACGTCGTACTGTTACGCG
GCTGCATCTTGCCGCGTCAA -> CTGCATCTTGCCGCGTCAAA
GTAAAAAACAGTCTTTAGAT -> TAAAAAACAGTCTTTAGATG
CAGACTCACGTCGATATTTT -> AGACTCACGTCGATATTTTG
CGCCGAATGCATACAATGAA -> GCCGAATGCATACAATGAAC
CACATTCTGAGATGTAGTGC -> ACATTCTGAGATGTAGTGCC
ATAAGTTAGCCCCCTCGGCC -> TAAGTTAGCCCCCTCGGCCC
GATGTAGTGCCCTAACCTAC -> ATGTAGTGCCCTAACCTACC
GCCCATCCTTGTGACGGCCG -> CCCATCCTTGTGACGGCCGG
CTCACATGCGCGATGAAGCA -> TCACATGCGCGATGAAGCAT
AGAGATCACGTTTACACATT -> GAGATCACGTTTACACATTC
GGCTCCGTCCATCTGATGGC -> GCTCCGTCCATCTGATGGCC
CCAATCGCGGTTGGAATCGC -> CAATCGCGGTTGGAATCGCA
GGTTGTCCCGAGGTATGGCT -> GTTGTCCCGAGGTATGGCTT
CCATATAGTCATCAATCCAA -> CATATAGTCATCAATCCAAT
CGCCATACGCCAGACTCACG -> GCCATACGCCAGACTCACGT
GTTTACACATTCTGAGATGT -> TTTACACATTCTGAGATGTA
GGCCCACGTGGGCCCCCTGA -> GCCCACGTGGGCCCCCTGAA
TAGCCCCCTCGGCCCACGTG -> AGCCCCCTCGGCCCACGTGG
TAGATGATGTGGTCTCACAT -> AGATGATGTGGTCTCACATG
TTTCCCCTCGAGAGATCACG -> TTCCCCTCGAGAGATCACGT
GCGGTTGGAATCGCACTGTC -> CGGTTGGAATCGCACTGTCT
CTATAACAGTAATGCGGTCT -> TATAACAGTAATGCGGTCTA
GCGACGTACTAAGGTTCCAG -> CGACGTACTAAGGTTCCAGC
TCGTACTGTTACGCGACAGA -> CGTACTGTTACGCGACAGAG
ACGTCGTACTGTTACGCGAC -> CGTCGTACTGTTACGCGACA
ATCATCGTATATGGGATTTC -> TCATCGTATATGGGATTTCA
ATGCGGTCTAGTGAAGAACT -> TGCGGTCTAGTGAAGAACTT
GAATTGTCTAGGACATTAAA -> AATTGTCTAGGACATTAAAC
TGAGCCTAGAGCTGCTGCAT -> GAGCCTAGAGCTGCTGCATC
GCAACAGCGAGCTACTCCTC -> CAACAGCGAGCTACTCCTCC
GCGACAGAGTTCAATGAGCC -> CGACAGAGTTCAATGAGCCG
TAGTGAAGAACTTTAGGTTT -> AGTGAAGAACTTTAGGTTTT
TCTCTGTACTCAGATCCTTA -> CTCTGTACTCAGATCCTTAA
TCGAATCGACGTTGGGCAAG -> CGAATCGACGTTGGGCAAGT
TGCCCTAACCTACCGGGTGC -> GCCCTAACCTACCGGGTGCA
CTAGAGCTGCTGCATCTTGC -> TAGAGCTGCTGCATCTTGCC
CTCGAGAGATCACGTTTACA -> TCGAGAGATCACGTTTACAC
GCTTCCTCGTGAGATATTGC -> CTTCCTCGTGAGATATTGCG
GCGATGAAGCATAAGCGTAT -> CGATGAAGCATAAGCGTATA
ACCCTAATCGGTGAATTGTC -> CCCTAATCGGTGAATTGTCT
AAACCCCAGCTCCGTAGCAA -> AACCCCAGCTCCGTAGCAAC
TAAGGAGCGACGTACTAAGG -> AAGGAGCGACGTACTAAGGT
CACCCGACACTTTGCCTTTC -> ACCCGACACTTTGCCTTTCC
CATCGTATATGGGATTTCAT -> ATCGTATATGGGATTTCATA
CGGCCTAGTTGGAGGTGCTC -> GGCCTAGTTGGAGGTGCTCC
AGTAGGCTGGCCCCGTGCTT -> GTAGGCTGGCCCCGTGCTTC
CTCAGATCCTTAAAGCTTGC -> TCAGATCCTTAAAGCTTGCA
GCCCAGGAACACTACCTGTA -> CCCAGGAACACTACCTGTAG
GGCCCCGTGCTTCCTCGTGA -> GCCCCGTGCTTCCTCGTGAG
AGCAACATCCCAATCCTATT -> GCAACATCCCAATCCTATTC
GCCGCGTCAAAGGACGGGCC -> CCGCGTCAAAGGACGGGCCG
ATATGGGATTTCATAGCACC -> TATGGGATTTCATAGCACCC
TATCGTATAAGTTAGCCCCC -> ATCGTATAAGTTAGCCCCCT
GCTTGGGCTCCAGGTTGTCC -> CTTGGGCTCCAGGTTGTCCC
TGGCAACTCGAATCGACGTT -> GGCAACTCGAATCGACGTTG
TCAATGAGCCGCCTGGCAAC -> CAATGAGCCGCCTGGCAACT
TGGTTACGGCCTAGTTGGAG -> GGTTACGGCCTAGTTGGAGG
CCCACGTGGGCCCCCTGAAG -> CCACGTGGGCCCCCTGAAGC
ACTCCTCCAAGCATGCTGAG -> CTCCTCCAAGCATGCTGAGT
TGCATACAATGAACTGACTA -> GCATACAATGAACTGACTAT
AAGGAGCGACGTACTAAGGT -> AGGAGCGACGTACTAAGGTT
AGCTGCTGCATCTTGCCGCG -> GCTGCTGCATCTTGCCGCGT
TGCTTCCTCGTGAGATATTG -> GCTTCCTCGTGAGATATTGC
TAGAGCTGCTGCATCTTGCC -> AGAGCTGCTGCATCTTGCCG
AAAACAGTCTTTAGATGATG -> AAACAGTCTTTAGATGATGT
CGGCAAGTAGGCTGGCCCCG -> GGCAAGTAGGCTGGCCCCGT
GTTGGGCAAGTACCCCCTAA -> TTGGGCAAGTACCCCCTAAC
GGCGGGCTCCGTCCATCTGA -> GCGGGCTCCGTCCATCTGAT
CAACATCCCAATCCTATTCC -> AACATCCCAATCCTATTCCG
CCAGACTCACGTCGATATTT -> CAGACTCACGTCGATATTTT
CACGTGGGCCCCCTGAAGCA -> ACGTGGGCCCCCTGAAGCAA
CAGTCTTTAGATGATGTGGT -> AGTCTTTAGATGATGTGGTC
CCTAGAGCTGCTGCATCTTG -> CTAGAGCTGCTGCATCTTGC
TACGGCCTAGTTGGAGGTGC -> ACGGCCTAGTTGGAGGTGCT
CGTTTCCCCTACGTGAGGTG -> GTTTCCCCTACGTGAGGTGC
GGAATCGCACTGTCTCTGTA -> GAATCGCACTGTCTCTGTAC
CTATCATCGTATATGGGATT -> TATCATCGTATATGGGATTT
CGCGTATAGCGGGCGGGCTC -> GCGTATAGCGGGCGGGCTCC
CCCTCGGCCCACGTGGGCCC -> CCTCGGCCCACGTGGGCCCC
TTGTCCCGAGGTATGGCTTC -> TGTCCCGAGGTATGGCTTCC
GGCCCATCCTTGTGACGGCC -> GCCCATCCTTGTGACGGCCG
ATACGCCAGACTCACGTCGA -> TACGCCAGACTCACGTCGAT
TTACGGCCTAGTTGGAGGTG -> TACGGCCTAGTTGGAGGTGC
TAGCGTACGACCATATAGTC -> AGCGTACGACCATATAGTCA
CCTGTAGGCGTCGGAGGCTT -> CTGTAGGCGTCGGAGGCTTG
CGTAGCAACATCCCAATCCT -> GTAGCAACATCCCAATCCTA
GCCGAATGCATACAATGAAC -> CCGAATGCATACAATGAACT
GTTTTGAGCCTAGAGCTGCT -> TTTTGAGCCTAGAGCTGCTG
TAGTTGGAGGTGCTCCACCC -> AGTTGGAGGTGCTCCACCCG
AGCCCAGCGCCGAATGCATA -> GCCCAGCGCCGAATGCATAC
GCCAGACTCACGTCGATATT -> CCAGACTCACGTCGATATTT
TATAAGTTAGCCCCCTCGGC -> ATAAGTTAGCCCCCTCGGCC
ACGTGGGCCCCCTGAAGCAA -> CGTGGGCCCCCTGAAGCAAC
CGCTATAACAGTAATGCGGT -> GCTATAACAGTAATGCGGTC
CGTAACTCATAGCGTACGAC -> GTAACTCATAGCGTACGACC
AGGTGGTTACGGCCTAGTTG -> GGTGGTTACGGCCTAGTTGG
GCTTCCACACGTCTGACGTC -> CTTCCACACGTCTGACGTCA
CCGAGGTATGGCTTCCACAC -> CGAGGTATGGCTTCCACACG
CTCCTCCAAGCATGCTGAGT -> TCCTCCAAGCATGCTGAGTG
AATCCTATTCCGCAGCGACC -> ATCCTATTCCGCAGCGACCA
GTTTCCCCTACGTGAGGTGC -> TTTCCCCTACGTGAGGTGCC
GTTCAATGAGCCGCCTGGCA -> TTCAATGAGCCGCCTGGCAA
ATGAAGCATAAGCGTATAGC -> TGAAGCATAAGCGTATAGCG
TCCCCTCGAGAGATCACGTT -> CCCCTCGAGAGATCACGTTT
GAATGCATACAATGAACTGA -> AATGCATACAATGAACTGAC
ACCTACCGGGTGCACGCCTT -> CCTACCGGGTGCACGCCTTA
ATATAGTCATCAATCCAATC -> TATAGTCATCAATCCAATCG
CCCCTAACAACCGTAACTCA -> CCCTAACAACCGTAACTCAT
GTGCGGTGCACGTTTCCCCT -> TGCGGTGCACGTTTCCCCTA
CTTTAGATGATGTGGTCTCA -> TTTAGATGATGTGGTCTCAC
ACATTAAACCCCAGCTCCGT -> CATTAAACCCCAGCTCCGTA
AGCACCCTAATCGGTGAATT -> GCACCCTAATCGGTGAATTG
CACGGGGTCCGTCCTATCAT -> ACGGGGTCCGTCCTATCATC
ATTAAACCCCAGCTCCGTAG -> TTAAACCCCAGCTCCGTAGC
ATCTTGCCGCGTCAAAGGAC -> TCTTGCCGCGTCAAAGGACG
CACGTTTCCCCTACGTGAGG -> ACGTTTCCCCTACGTGAGGT
CCGACACCCGCGTATAGCGG -> CGACACCCGCGTATAGCGGG
CAATCGCGGTTGGAATCGCA -> AATCGCGGTTGGAATCGCAC
CGTGAGATATTGCGCCGACA -> GTGAGATATTGCGCCGACAC
TGGAATCGCACTGTCTCTGT -> GGAATCGCACTGTCTCTGTA
GGCAAGTACCCCCTAACAAC -> GCAAGTACCCCCTAACAACC
TTCCTCGTGAGATATTGCGC -> TCCTCGTGAGATATTGCGCC
CCGGGTGCACGCCTTATTGT -> CGGGTGCACGCCTTATTGTA
GTCTCACATGCGCGATGAAG -> TCTCACATGCGCGATGAAGC
GGCCCCCTGAAGCAACAGCG -> GCCCCCTGAAGCAACAGCGA
TGTGGTCTCACATGCGCGAT -> GTGGTCTCACATGCGCGATG
AGCCCCCTCGGCCCACGTGG -> GCCCCCTCGGCCCACGTGGG
CAACCGTAACTCATAGCGTA -> AACCGTAACTCATAGCGTAC
GTAGTGCCCTAACCTACCGG -> TAGTGCCCTAACCTACCGGG
TCCTCCAAGCATGCTGAGTG -> CCTCCAAGCATGCTGAGTGC
GTTAGCCCCCTCGGCCCACG -> TTAGCCCCCTCGGCCCACGT
AATCGGTGAATTGTCTAGGA -> ATCGGTGAATTGTCTAGGAC
GCACTGTCTCTGTACTCAGA -> CACTGTCTCTGTACTCAGAT
CCCCCTAACAACCGTAACTC -> CCCCTAACAACCGTAACTCA
CTTGTGACGGCCGGCGTTAC -> TTGTGACGGCCGGCGTTACC
AAGTTAGCCCCCTCGGCCCA -> AGTTAGCCCCCTCGGCCCAC
TGCACGTTTCCCCTACGTGA -> GCACGTTTCCCCTACGTGAG
TTGTCTAGGACATTAAACGG -> TGTCTAGGACATTAAACGGC
ATTAAACGGCAAGTAGGCTG -> TTAAACGGCAAGTAGGCTGG
TGGGCAAGTACCCCCTAACA -> GGGCAAGTACCCCCTAACAA
CCGCGCAGCCCAGGAACACT -> CGCGCAGCCCAGGAACACTA
CCGTAGCAACATCCCAATCC -> CGTAGCAACATCCCAATCCT
CGTATAGCGGTTGGGGCACG -> GTATAGCGGTTGGGGCACGG
AATGCATACAATGAACTGAC -> ATGCATACAATGAACTGACT
GACGGGCCGCGCAGCCCAGG -> ACGGGCCGCGCAGCCCAGGA
AACGCCATACGCCAGACTCA -> ACGCCATACGCCAGACTCAC
GGTTCCAGCCCAGCGCCGAA -> GTTCCAGCCCAGCGCCGAAT
ATGGCTTCCACACGTCTGAC -> TGGCTTCCACACGTCTGACG
ATCGCACTGTCTCTGTACTC -> TCGCACTGTCTCTGTACTCA
AATCGCGGTTGGAATCGCAC -> ATCGCGGTTGGAATCGCACT
CTGTTACGCGACAGAGTTCA -> TGTTACGCGACAGAGTTCAA
GATGGCCCATCCTTGTGACG -> ATGGCCCATCCTTGTGACGG
GTTCCAGCCCAGCGCCGAAT -> TTCCAGCCCAGCGCCGAATG
GTACTAAGGTTCCAGCCCAG -> TACTAAGGTTCCAGCCCAGC
GAGTGCGGTGCACGTTTCCC -> AGTGCGGTGCACGTTTCCCC
CCGCAGCGACCAAGAGCTAT -> CGCAGCGACCAAGAGCTATG
GTCATCAATCCAATCGCGGT -> TCATCAATCCAATCGCGGTT
TAGCGGGCGGGCTCCGTCCA -> AGCGGGCGGGCTCCGTCCAT
AGATGATGTGGTCTCACATG -> GATGATGTGGTCTCACATGC
GTCTAGGACATTAAACGGCA -> TCTAGGACATTAAACGGCAA
CGTCGTACTGTTACGCGACA -> GTCGTACTGTTACGCGACAG
TCAATCCAATCGCGGTTGGA -> CAATCCAATCGCGGTTGGAA
GTATAGCGGGCGGGCTCCGT -> TATAGCGGGCGGGCTCCGTC
GACGTCAACTTAAGGAGCGA -> ACGTCAACTTAAGGAGCGAC
GACACCCGCGTATAGCGGGC -> ACACCCGCGTATAGCGGGCG
CGCGACAGAGTTCAATGAGC -> GCGACAGAGTTCAATGAGCC
GCCCTAACCTACCGGGTGCA -> CCCTAACCTACCGGGTGCAC
CAACTTAAGGAGCGACGTAC -> AACTTAAGGAGCGACGTACT
GACCCGCTATAACAGTAATG -> ACCCGCTATAACAGTAATGC
TCCTCGTGAGATATTGCGCC -> CCTCGTGAGATATTGCGCCG
GGAACACTACCTGTAGGCGT -> GAACACTACCTGTAGGCGTC
TCGCGGTTGGAATCGCACTG -> CGCGGTTGGAATCGCACTGT
TACGACCATATAGTCATCAA -> ACGACCATATAGTCATCAAT
CACTACCTGTAGGCGTCGGA -> ACTACCTGTAGGCGTCGGAG
TCTAGTGAAGAACTTTAGGT -> CTAGTGAAGAACTTTAGGTT
GCAGGTGGTTACGGCCTAGT -> CAGGTGGTTACGGCCTAGTT
CGAGGTATGGCTTCCACACG -> GAGGTATGGCTTCCACACGT
AGGACGGGCCGCGCAGCCCA -> GGACGGGCCGCGCAGCCCAG
GAGCGACGTACTAAGGTTCC -> AGCGACGTACTAAGGTTCCA
GTCTGACGTCAACTTAAGGA -> TCTGACGTCAACTTAAGGAG
TCCAGGTTGTCCCGAGGTAT -> CCAGGTTGTCCCGAGGTATG
TCCTTGTGACGGCCGGCGTT -> CCTTGTGACGGCCGGCGTTA
GTTGTCCCGAGGTATGGCTT -> TTGTCCCGAGGTATGGCTTC
CGCACTGTCTCTGTACTCAG -> GCACTGTCTCTGTACTCAGA
TTTACACATTCTGAGATGTA -> TTACACATTCTGAGATGTAG
TGCCGACCCGCTATAACAGT -> GCCGACCCGCTATAACAGTA
TATGCTCCGAACGTAAAAAA -> ATGCTCCGAACGTAAAAAAC
GGCTGGCCCCGTGCTTCCTC -> GCTGGCCCCGTGCTTCCTCG
TGCTGCATCTTGCCGCGTCA -> GCTGCATCTTGCCGCGTCAA
CTCCGTAGCAACATCCCAAT -> TCCGTAGCAACATCCCAATC
CGGAGGCTTGGGCTCCAGGT -> GGAGGCTTGGGCTCCAGGTT
ATAGCGGGCGGGCTCCGTCC -> TAGCGGGCGGGCTCCGTCCA
AGCGACGTACTAAGGTTCCA -> GCGACGTACTAAGGTTCCAG
TGGTCTCACATGCGCGATGA -> GGTCTCACATGCGCGATGAA
CCTAATCGGTGAATTGTCTA -> CTAATCGGTGAATTGTCTAG
TCATCGTATATGGGATTTCA -> CATCGTATATGGGATTTCAT
TAAAGCTTGCACCCGACACT -> AAAGCTTGCACCCGACACTT
AGCTACTCCTCCAAGCATGC -> GCTACTCCTCCAAGCATGCT
CGCGCAGCCCAGGAACACTA -> GCGCAGCCCAGGAACACTAC
ACTGTCTCTGTACTCAGATC -> CTGTCTCTGTACTCAGATCC
GGTGCTCCACCCGTACGTCG -> GTGCTCCACCCGTACGTCGT
CTAGTGAAGAACTTTAGGTT -> TAGTGAAGAACTTTAGGTTT
AATCGCACTGTCTCTGTACT -> ATCGCACTGTCTCTGTACTC
TGATGGCCCATCCTTGTGAC -> GATGGCCCATCCTTGTGACG
TTAAACCCCAGCTCCGTAGC -> TAAACCCCAGCTCCGTAGCA
AAAGCTTGCACCCGACACTT -> AAGCTTGCACCCGACACTTT
GCCGGCGTTACCCCAAACGC -> CCGGCGTTACCCCAAACGCC
GTAACTCATAGCGTACGACC -> TAACTCATAGCGTACGACCA
AGCATAAGCGTATAGCGGTT -> GCATAAGCGTATAGCGGTTG
GGTGGTTACGGCCTAGTTGG -> GTGGTTACGGCCTAGTTGGA
ACCCCCTAACAACCGTAACT -> CCCCCTAACAACCGTAACTC
GAGCTGCTGCATCTTGCCGC -> AGCTGCTGCATCTTGCCGCG
AACATTAAACCCCAGCTCCG -> ACATTAAACCCCAGCTCCGT
TGACTATCATAACATTAAAC -> GACTATCATAACATTAAACC
TCCTTAAAGCTTGCACCCGA -> CCTTAAAGCTTGCACCCGAC
ACAATGAACTGACTATCATA -> CAATGAACTGACTATCATAA
GTAGGCTGGCCCCGTGCTTC -> TAGGCTGGCCCCGTGCTTCC
GTCAACTTAAGGAGCGACGT -> TCAACTTAAGGAGCGACGTA
CGGTCTAGTGAAGAACTTTA -> GGTCTAGTGAAGAACTTTAG
AGCCCAGGAACACTACCTGT -> GCCCAGGAACACTACCTGTA
GTGCACGCCTTATTGTATCG -> TGCACGCCTTATTGTATCGT
CGCAGCCCAGGAACACTACC -> GCAGCCCAGGAACACTACCT
GAGATGTAGTGCCCTAACCT -> AGATGTAGTGCCCTAACCTA
CACGTTTACACATTCTGAGA -> ACGTTTACACATTCTGAGAT
ACGCGACAGAGTTCAATGAG -> CGCGACAGAGTTCAATGAGC
TAACAGTAATGCGGTCTAGT -> AACAGTAATGCGGTCTAGTG
GGGCTCCGTCCATCTGATGG -> GGCTCCGTCCATCTGATGGC
CCCCAAACGCCATACGCCAG -> CCCAAACGCCATACGCCAGA
CACTGTCTCTGTACTCAGAT -> ACTGTCTCTGTACTCAGATC
GTGACGGCCGGCGTTACCCC -> TGACGGCCGGCGTTACCCCA
AACACGCAGGTGGTTACGGC -> ACACGCAGGTGGTTACGGCC
GCGGTGCACGTTTCCCCTAC -> CGGTGCACGTTTCCCCTACG
CTGGCAACTCGAATCGACGT -> TGGCAACTCGAATCGACGTT
GACGTACTAAGGTTCCAGCC -> ACGTACTAAGGTTCCAGCCC
AGGCTTGGGCTCCAGGTTGT -> GGCTTGGGCTCCAGGTTGTC
TCAACTTAAGGAGCGACGTA -> CAACTTAAGGAGCGACGTAC
CTCGGCCCACGTGGGCCCCC -> TCGGCCCACGTGGGCCCCCT
CGTATAGCGGGCGGGCTCCG -> GTATAGCGGGCGGGCTCCGT
GAGGCTTGGGCTCCAGGTTG -> AGGCTTGGGCTCCAGGTTGT
TCGGAGGCTTGGGCTCCAGG -> CGGAGGCTTGGGCTCCAGGT
ATAGCGGTTGGGGCACGGGG -> TAGCGGTTGGGGCACGGGGT
AAGTAGGCTGGCCCCGTGCT -> AGTAGGCTGGCCCCGTGCTT
CCGTCCATCTGATGGCCCAT -> CGTCCATCTGATGGCCCATC
GTGAGGTGCCGACCCGCTAT -> TGAGGTGCCGACCCGCTATA
AGCGACCAAGAGCTATGCTC -> GCGACCAAGAGCTATGCTCC
AGCGGGCGGGCTCCGTCCAT -> GCGGGCGGGCTCCGTCCATC
CTAGGACATTAAACGGCAAG -> TAGGACATTAAACGGCAAGT
TATCATCGTATATGGGATTT -> ATCATCGTATATGGGATTTC
ACACCCGCGTATAGCGGGCG -> CACCCGCGTATAGCGGGCGG
GCAACATCCCAATCCTATTC -> CAACATCCCAATCCTATTCC
CTATTCCGCAGCGACCAAGA -> TATTCCGCAGCGACCAAGAG
CATCCCAATCCTATTCCGCA -> ATCCCAATCCTATTCCGCAG
TTACACATTCTGAGATGTAG -> TACACATTCTGAGATGTAGT
CGCAGGTGGTTACGGCCTAG -> GCAGGTGGTTACGGCCTAGT
TCCCGAGGTATGGCTTCCAC -> CCCGAGGTATGGCTTCCACA
GGTTACGGCCTAGTTGGAGG -> GTTACGGCCTAGTTGGAGGT
CGTCCTATCATCGTATATGG -> GTCCTATCATCGTATATGGG
CCTTATTGTATCGTATAAGT -> CTTATTGTATCGTATAAGTT
ATCCCAATCCTATTCCGCAG -> TCCCAATCCTATTCCGCAGC
ATAACAGTAATGCGGTCTAG -> TAACAGTAATGCGGTCTAGT
CGAGAGATCACGTTTACACA -> GAGAGATCACGTTTACACAT
GCATAAGCGTATAGCGGTTG -> CATAAGCGTATAGCGGTTGG
ATGATGTGGTCTCACATGCG -> TGATGTGGTCTCACATGCGC
GTAATGCGGTCTAGTGAAGA -> TAATGCGGTCTAGTGAAGAA
CGGTTGGAATCGCACTGTCT -> GGTTGGAATCGCACTGTCTC
GTCCTATCATCGTATATGGG -> TCCTATCATCGTATATGGGA
ACTTTGCCTTTCCCCTCGAG -> CTTTGCCTTTCCCCTCGAGA
AGAGCTATGCTCCGAACGTA -> GAGCTATGCTCCGAACGTAA
GCACGTTTCCCCTACGTGAG -> CACGTTTCCCCTACGTGAGG
TAACTCATAGCGTACGACCA -> AACTCATAGCGTACGACCAT
CTAATCGGTGAATTGTCTAG -> TAATCGGTGAATTGTCTAGG
GACCATATAGTCATCAATCC -> ACCATATAGTCATCAATCCA
CGCGGTTGGAATCGCACTGT -> GCGGTTGGAATCGCACTGTC
TCCTATCATCGTATATGGGA -> CCTATCATCGTATATGGGAT
GGAGGCTTGGGCTCCAGGTT -> GAGGCTTGGGCTCCAGGTTG
TCTGATGGCCCATCCTTGTG -> CTGATGGCCCATCCTTGTGA
GCATCTTGCCGCGTCAAAGG -> CATCTTGCCGCGTCAAAGGA
GAGTTCAATGAGCCGCCTGG -> AGTTCAATGAGCCGCCTGGC
CATACAATGAACTGACTATC -> ATACAATGAACTGACTATCA
GCGACCAAGAGCTATGCTCC -> CGACCAAGAGCTATGCTCCG
AAAGGACGGGCCGCGCAGCC -> AAGGACGGGCCGCGCAGCCC
ATGTGGTCTCACATGCGCGA -> TGTGGTCTCACATGCGCGAT
TGAAGCAACAGCGAGCTACT -> GAAGCAACAGCGAGCTACTC
TACGTGAGGTGCCGACCCGC -> ACGTGAGGTGCCGACCCGCT
ACAGTAATGCGGTCTAGTGA -> CAGTAATGCGGTCTAGTGAA
TGCGCGATGAAGCATAAGCG -> GCGCGATGAAGCATAAGCGT
GTCAAAGGACGGGCCGCGCA -> TCAAAGGACGGGCCGCGCAG
ACTCAGATCCTTAAAGCTTG -> CTCAGATCCTTAAAGCTTGC
TGGGATTTCATAGCACCCTA -> GGGATTTCATAGCACCCTAA
GTCCATCTGATGGCCCATCC -> TCCATCTGATGGCCCATCCT
GCCTAGAGCTGCTGCATCTT -> CCTAGAGCTGCTGCATCTTG
TCACATGCGCGATGAAGCAT -> CACATGCGCGATGAAGCATA
GATGAAGCATAAGCGTATAG -> ATGAAGCATAAGCGTATAGC
GTAGGCGTCGGAGGCTTGGG -> TAGGCGTCGGAGGCTTGGGC
GCCTGGCAACTCGAATCGAC -> CCTGGCAACTCGAATCGACG
TAATCGGTGAATTGTCTAGG -> AATCGGTGAATTGTCTAGGA
TGGAGGTGCTCCACCCGTAC -> GGAGGTGCTCCACCCGTACG
TATAGCGGGCGGGCTCCGTC -> ATAGCGGGCGGGCTCCGTCC
CGCGATGAAGCATAAGCGTA -> GCGATGAAGCATAAGCGTAT
ATCGTATATGGGATTTCATA -> TCGTATATGGGATTTCATAG
AAAAACAGTCTTTAGATGAT -> AAAACAGTCTTTAGATGATG
CGTATAAGTTAGCCCCCTCG -> GTATAAGTTAGCCCCCTCGG
CGGCCGGCGTTACCCCAAAC -> GGCCGGCGTTACCCCAAACG
GTACGACCATATAGTCATCA -> TACGACCATATAGTCATCAA
AGAACTTTAGGTTTTGAGCC -> GAACTTTAGGTTTTGAGCCT
CCGTCCTATCATCGTATATG -> CGTCCTATCATCGTATATGG
AACTCGAATCGACGTTGGGC -> ACTCGAATCGACGTTGGGCA
AAGGTTCCAGCCCAGCGCCG -> AGGTTCCAGCCCAGCGCCGA
CCATACGCCAGACTCACGTC -> CATACGCCAGACTCACGTCG
CACCCTAATCGGTGAATTGT -> ACCCTAATCGGTGAATTGTC
TTAGCCCCCTCGGCCCACGT -> TAGCCCCCTCGGCCCACGTG
GTACCCCCTAACAACCGTAA -> TACCCCCTAACAACCGTAAC
CTTAAAGCTTGCACCCGACA -> TTAAAGCTTGCACCCGACAC
GCTCCGAACGTAAAAAACAG -> CTCCGAACGTAAAAAACAGT
CGACGTACTAAGGTTCCAGC -> GACGTACTAAGGTTCCAGCC
ACTACCTGTAGGCGTCGGAG -> CTACCTGTAGGCGTCGGAGG
TGAAGAACTTTAGGTTTTGA -> GAAGAACTTTAGGTTTTGAG
TACGCCAGACTCACGTCGAT -> ACGCCAGACTCACGTCGATA
AGCTATGCTCCGAACGTAAA -> GCTATGCTCCGAACGTAAAA
GAGATCACGTTTACACATTC -> AGATCACGTTTACACATTCT
ATTTCATAGCACCCTAATCG -> TTTCATAGCACCCTAATCGG
CGTCCATCTGATGGCCCATC -> GTCCATCTGATGGCCCATCC
CCGACCCGCTATAACAGTAA -> CGACCCGCTATAACAGTAAT
TCGACGTTGGGCAAGTACCC -> CGACGTTGGGCAAGTACCCC
CCCTAACCTACCGGGTGCAC -> CCTAACCTACCGGGTGCACG
AAACGCCATACGCCAGACTC -> AACGCCATACGCCAGACTCA
GAGCCGCCTGGCAACTCGAA -> AGCCGCCTGGCAACTCGAAT
AACCCCAGCTCCGTAGCAAC -> ACCCCAGCTCCGTAGCAACA
TGGGCTCCAGGTTGTCCCGA -> GGGCTCCAGGTTGTCCCGAG
CTATCATAACATTAAACCCC -> TATCATAACATTAAACCCCA
CTTTAGGTTTTGAGCCTAGA -> TTTAGGTTTTGAGCCTAGAG
GAGCTACTCCTCCAAGCATG -> AGCTACTCCTCCAAGCATGC
ACGTAAAAAACAGTCTTTAG -> CGTAAAAAACAGTCTTTAGA
CGTACGACCATATAGTCATC -> GTACGACCATATAGTCATCA
TTATTGTATCGTATAAGTTA -> TATTGTATCGTATAAGTTAG
GTGCCCTAACCTACCGGGTG -> TGCCCTAACCTACCGGGTGC
GTATAGCGGTTGGGGCACGG -> TATAGCGGTTGGGGCACGGG
AGGTATGGCTTCCACACGTC -> GGTATGGCTTCCACACGTCT
AAGAACTTTAGGTTTTGAGC -> AGAACTTTAGGTTTTGAGCC
CGACACTTTGCCTTTCCCCT -> GACACTTTGCCTTTCCCCTC
TAGGCTGGCCCCGTGCTTCC -> AGGCTGGCCCCGTGCTTCCT
TCATAGCACCCTAATCGGTG -> CATAGCACCCTAATCGGTGA
GGTCTAGTGAAGAACTTTAG -> GTCTAGTGAAGAACTTTAGG
TTTTGAGCCTAGAGCTGCTG -> TTTGAGCCTAGAGCTGCTGC
GTTGGAATCGCACTGTCTCT -> TTGGAATCGCACTGTCTCTG
CCCATCCTTGTGACGGCCGG -> CCATCCTTGTGACGGCCGGC
CATCCTTGTGACGGCCGGCG -> ATCCTTGTGACGGCCGGCGT
GCGCGATGAAGCATAAGCGT -> CGCGATGAAGCATAAGCGTA
TTGCCGCGTCAAAGGACGGG -> TGCCGCGTCAAAGGACGGGC
ATTGTCTAGGACATTAAACG -> TTGTCTAGGACATTAAACGG
CCGCGTATAGCGGGCGGGCT -> CGCGTATAGCGGGCGGGCTC
TAACAACCGTAACTCATAGC -> AACAACCGTAACTCATAGCG
TGTCTCTGTACTCAGATCCT -> GTCTCTGTACTCAGATCCTT
TGTATCGTATAAGTTAGCCC -> GTATCGTATAAGTTAGCCCC
GTCTTTAGATGATGTGGTCT -> TCTTTAGATGATGTGGTCTC
CGACCATATAGTCATCAATC -> GACCATATAGTCATCAATCC
TCTCACATGCGCGATGAAGC -> CTCACATGCGCGATGAAGCA
TTGGGCTCCAGGTTGTCCCG -> TGGGCTCCAGGTTGTCCCGA
ACAACCGTAACTCATAGCGT -> CAACCGTAACTCATAGCGTA
CCGTGCTTCCTCGTGAGATA -> CGTGCTTCCTCGTGAGATAT
TACCCCCTAACAACCGTAAC -> ACCCCCTAACAACCGTAACT
CGAACGTAAAAAACAGTCTT -> GAACGTAAAAAACAGTCTTT
TGACGGCCGGCGTTACCCCA -> GACGGCCGGCGTTACCCCAA
GACTATCATAACATTAAACC -> ACTATCATAACATTAAACCC
CAGGTTGTCCCGAGGTATGG -> AGGTTGTCCCGAGGTATGGC
TGCCTTTCCCCTCGAGAGAT -> GCCTTTCCCCTCGAGAGATC
GTGGGCCCCCTGAAGCAACA -> TGGGCCCCCTGAAGCAACAG
ACACATTCTGAGATGTAGTG -> CACATTCTGAGATGTAGTGC
GGTGAATTGTCTAGGACATT -> GTGAATTGTCTAGGACATTA
CGAGCTACTCCTCCAAGCAT -> GAGCTACTCCTCCAAGCATG
TTTCCCCTACGTGAGGTGCC -> TTCCCCTACGTGAGGTGCCG
CATCAATCCAATCGCGGTTG -> ATCAATCCAATCGCGGTTGG
CCGCTATAACAGTAATGCGG -> CGCTATAACAGTAATGCGGT
AACATCCCAATCCTATTCCG -> ACATCCCAATCCTATTCCGC
CCATCTGATGGCCCATCCTT -> CATCTGATGGCCCATCCTTG
TCGCACTGTCTCTGTACTCA -> CGCACTGTCTCTGTACTCAG
GTTGGGGCACGGGGTCCGTC -> TTGGGGCACGGGGTCCGTCC
CGGCCCACGTGGGCCCCCTG -> GGCCCACGTGGGCCCCCTGA
GAATCGCACTGTCTCTGTAC -> AATCGCACTGTCTCTGTACT
GAGCTATGCTCCGAACGTAA -> AGCTATGCTCCGAACGTAAA
CAGAGTTCAATGAGCCGCCT -> AGAGTTCAATGAGCCGCCTG
ATGAGCCGCCTGGCAACTCG -> TGAGCCGCCTGGCAACTCGA
CAGCGACCAAGAGCTATGCT -> AGCGACCAAGAGCTATGCTC
ATCCTTAAAGCTTGCACCCG -> TCCTTAAAGCTTGCACCCGA
CCAAGCATGCTGAGTGCGGT -> CAAGCATGCTGAGTGCGGTG
ATCCAATCGCGGTTGGAATC -> TCCAATCGCGGTTGGAATCG
CACGCAGGTGGTTACGGCCT -> ACGCAGGTGGTTACGGCCTA
AGTGCCCTAACCTACCGGGT -> GTGCCCTAACCTACCGGGTG
GTTACCCCAAACGCCATACG -> TTACCCCAAACGCCATACGC
CCACCCGTACGTCGTACTGT -> CACCCGTACGTCGTACTGTT
GTATGGCTTCCACACGTCTG -> TATGGCTTCCACACGTCTGA
CGCCAGACTCACGTCGATAT -> GCCAGACTCACGTCGATATT
CTGAAGCAACAGCGAGCTAC -> TGAAGCAACAGCGAGCTACT
CCTCCAAGCATGCTGAGTGC -> CTCCAAGCATGCTGAGTGCG
GTGCCGACCCGCTATAACAG -> TGCCGACCCGCTATAACAGT
AGTCATCAATCCAATCGCGG -> GTCATCAATCCAATCGCGGT
GGGCGGGCTCCGTCCATCTG -> GGCGGGCTCCGTCCATCTGA
CCCGAGGTATGGCTTCCACA -> CCGAGGTATGGCTTCCACAC
CGACACCCGCGTATAGCGGG -> GACACCCGCGTATAGCGGGC
GCGTCAAAGGACGGGCCGCG -> CGTCAAAGGACGGGCCGCGC
ACTGACTATCATAACATTAA -> CTGACTATCATAACATTAAA
CTTTGCCTTTCCCCTCGAGA -> TTTGCCTTTCCCCTCGAGAG
TTGGGGCACGGGGTCCGTCC -> TGGGGCACGGGGTCCGTCCT
CCCCTGAAGCAACAGCGAGC -> CCCTGAAGCAACAGCGAGCT
CCCGTACGTCGTACTGTTAC -> CCGTACGTCGTACTGTTACG
GAGCCTAGAGCTGCTGCATC -> AGCCTAGAGCTGCTGCATCT
GCTATAACAGTAATGCGGTC -> CTATAACAGTAATGCGGTCT
TGCTGAGTGCGGTGCACGTT -> GCTGAGTGCGGTGCACGTTT
TTCCAGCCCAGCGCCGAATG -> TCCAGCCCAGCGCCGAATGC
ACGACCATATAGTCATCAAT -> CGACCATATAGTCATCAATC
CGACCCGCTATAACAGTAAT -> GACCCGCTATAACAGTAATG
ATCACGTTTACACATTCTGA -> TCACGTTTACACATTCTGAG
TGCGGTCTAGTGAAGAACTT -> GCGGTCTAGTGAAGAACTTT
ATCTGATGGCCCATCCTTGT -> TCTGATGGCCCATCCTTGTG
AGGTGCCGACCCGCTATAAC -> GGTGCCGACCCGCTATAACA
CCCAATCCTATTCCGCAGCG -> CCAATCCTATTCCGCAGCGA
CATAGCACCCTAATCGGTGA -> ATAGCACCCTAATCGGTGAA
CTTTCCCCTCGAGAGATCAC -> TTTCCCCTCGAGAGATCACG
TGTAGTGCCCTAACCTACCG -> GTAGTGCCCTAACCTACCGG
CTAACAACCGTAACTCATAG -> TAACAACCGTAACTCATAGC
GTGAATTGTCTAGGACATTA -> TGAATTGTCTAGGACATTAA
TATTGTATCGTATAAGTTAG -> ATTGTATCGTATAAGTTAGC
GTATAAGTTAGCCCCCTCGG -> TATAAGTTAGCCCCCTCGGC
ACATGCGCGATGAAGCATAA -> CATGCGCGATGAAGCATAAG
TAACCTACCGGGTGCACGCC -> AACCTACCGGGTGCACGCCT
ATTGCGCCGACACCCGCGTA -> TTGCGCCGACACCCGCGTAT
CCTTAAAGCTTGCACCCGAC -> CTTAAAGCTTGCACCCGACA
AAGTACCCCCTAACAACCGT -> AGTACCCCCTAACAACCGTA
TTGCGCCGACACCCGCGTAT -> TGCGCCGACACCCGCGTATA
TCTAGGACATTAAACGGCAA -> CTAGGACATTAAACGGCAAG
GAAGAACTTTAGGTTTTGAG -> AAGAACTTTAGGTTTTGAGC
GGGGCACGGGGTCCGTCCTA -> GGGCACGGGGTCCGTCCTAT
GACAGAGTTCAATGAGCCGC -> ACAGAGTTCAATGAGCCGCC
CAGATCCTTAAAGCTTGCAC -> AGATCCTTAAAGCTTGCACC
TCAAAGGACGGGCCGCGCAG -> CAAAGGACGGGCCGCGCAGC
AGCCGCCTGGCAACTCGAAT -> GCCGCCTGGCAACTCGAATC
GTCTAGTGAAGAACTTTAGG -> TCTAGTGAAGAACTTTAGGT
AACCTACCGGGTGCACGCCT -> ACCTACCGGGTGCACGCCTT
GAAGCAACAGCGAGCTACTC -> AAGCAACAGCGAGCTACTCC
GCCGACCCGCTATAACAGTA -> CCGACCCGCTATAACAGTAA
GGGCAAGTACCCCCTAACAA -> GGCAAGTACCCCCTAACAAC
TAATGCGGTCTAGTGAAGAA -> AATGCGGTCTAGTGAAGAAC
GAGGTGCCGACCCGCTATAA -> AGGTGCCGACCCGCTATAAC
CCCCCTCGGCCCACGTGGGC -> CCCCTCGGCCCACGTGGGCC
ACCCCAAACGCCATACGCCA -> CCCCAAACGCCATACGCCAG
ACTGTTACGCGACAGAGTTC -> CTGTTACGCGACAGAGTTCA
CCTACCGGGTGCACGCCTTA -> CTACCGGGTGCACGCCTTAT
CAAGCATGCTGAGTGCGGTG -> AAGCATGCTGAGTGCGGTGC
ACCGGGTGCACGCCTTATTG -> CCGGGTGCACGCCTTATTGT
GCCTTTCCCCTCGAGAGATC -> CCTTTCCCCTCGAGAGATCA
TTCTGAGATGTAGTGCCCTA -> TCTGAGATGTAGTGCCCTAA
CCGTAACTCATAGCGTACGA -> CGTAACTCATAGCGTACGAC
CTTCCACACGTCTGACGTCA -> TTCCACACGTCTGACGTCAA
TGGGGCACGGGGTCCGTCCT -> GGGGCACGGGGTCCGTCCTA
CCCCCTGAAGCAACAGCGAG -> CCCCTGAAGCAACAGCGAGC
GCTCCAGGTTGTCCCGAGGT -> CTCCAGGTTGTCCCGAGGTA
GGCAAGTAGGCTGGCCCCGT -> GCAAGTAGGCTGGCCCCGTG
TTGCCTTTCCCCTCGAGAGA -> TGCCTTTCCCCTCGAGAGAT
CGTACTGTTACGCGACAGAG -> GTACTGTTACGCGACAGAGT
GGTTGGAATCGCACTGTCTC -> GTTGGAATCGCACTGTCTCT
CAAAGGACGGGCCGCGCAGC -> AAAGGACGGGCCGCGCAGCC
TGACGTCAACTTAAGGAGCG -> GACGTCAACTTAAGGAGCGA
CTAACCTACCGGGTGCACGC -> TAACCTACCGGGTGCACGCC
TTACCCCAAACGCCATACGC -> TACCCCAAACGCCATACGCC
CAGCCCAGGAACACTACCTG -> AGCCCAGGAACACTACCTGT
GGTTTTGAGCCTAGAGCTGC -> GTTTTGAGCCTAGAGCTGCT
GCCCCCTGAAGCAACAGCGA -> CCCCCTGAAGCAACAGCGAG
GTTGGAGGTGCTCCACCCGT -> TTGGAGGTGCTCCACCCGTA
AAGCTTGCACCCGACACTTT -> AGCTTGCACCCGACACTTTG
CCGGCGTTACCCCAAACGCC -> CGGCGTTACCCCAAACGCCA
TAGTCATCAATCCAATCGCG -> AGTCATCAATCCAATCGCGG
ATAAGCGTATAGCGGTTGGG -> TAAGCGTATAGCGGTTGGGG
GTGGTCTCACATGCGCGATG -> TGGTCTCACATGCGCGATGA
TTGGAGGTGCTCCACCCGTA -> TGGAGGTGCTCCACCCGTAC
GCAGCCCAGGAACACTACCT -> CAGCCCAGGAACACTACCTG
CTGGCCCCGTGCTTCCTCGT -> TGGCCCCGTGCTTCCTCGTG
ACATTCTGAGATGTAGTGCC -> CATTCTGAGATGTAGTGCCC
CAGCGCCGAATGCATACAAT -> AGCGCCGAATGCATACAATG
GATTTCATAGCACCCTAATC -> ATTTCATAGCACCCTAATCG
CACTTTGCCTTTCCCCTCGA -> ACTTTGCCTTTCCCCTCGAG
GACGGCCGGCGTTACCCCAA -> ACGGCCGGCGTTACCCCAAA
CGGGCTCCGTCCATCTGATG -> GGGCTCCGTCCATCTGATGG
GGGTGCACGCCTTATTGTAT -> GGTGCACGCCTTATTGTATC
TCCGTCCTATCATCGTATAT -> CCGTCCTATCATCGTATATG
TATCATAACATTAAACCCCA -> ATCATAACATTAAACCCCAG
CCCCGTGCTTCCTCGTGAGA -> CCCGTGCTTCCTCGTGAGAT
TCGAGAGATCACGTTTACAC -> CGAGAGATCACGTTTACACA
GCGTCGGAGGCTTGGGCTCC -> CGTCGGAGGCTTGGGCTCCA
CAGGAACACTACCTGTAGGC -> AGGAACACTACCTGTAGGCG
TAAGTTAGCCCCCTCGGCCC -> AAGTTAGCCCCCTCGGCCCA
AACAACCGTAACTCATAGCG -> ACAACCGTAACTCATAGCGT
TGGCTTCCACACGTCTGACG -> GGCTTCCACACGTCTGACGT
TAAACGGCAAGTAGGCTGGC -> AAACGGCAAGTAGGCTGGCC
CCTCGTGAGATATTGCGCCG -> CTCGTGAGATATTGCGCCGA
AGATGTAGTGCCCTAACCTA -> GATGTAGTGCCCTAACCTAC
AACACTACCTGTAGGCGTCG -> ACACTACCTGTAGGCGTCGG
AGTTAGCCCCCTCGGCCCAC -> GTTAGCCCCCTCGGCCCACG
CCAAGAGCTATGCTCCGAAC -> CAAGAGCTATGCTCCGAACG
CTTCCTCGTGAGATATTGCG -> TTCCTCGTGAGATATTGCGC
TGGCCCATCCTTGTGACGGC -> GGCCCATCCTTGTGACGGCC
CCCGCTATAACAGTAATGCG -> CCGCTATAACAGTAATGCGG
ACTTAAGGAGCGACGTACTA -> CTTAAGGAGCGACGTACTAA
CGTCGGAGGCTTGGGCTCCA -> GTCGGAGGCTTGGGCTCCAG
TCTTGCCGCGTCAAAGGACG -> CTTGCCGCGTCAAAGGACGG
CCCGTGCTTCCTCGTGAGAT -> CCGTGCTTCCTCGTGAGATA
TTGTGACGGCCGGCGTTACC -> TGTGACGGCCGGCGTTACCC
CGGGGTCCGTCCTATCATCG -> GGGGTCCGTCCTATCATCGT
CGCCTTATTGTATCGTATAA -> GCCTTATTGTATCGTATAAG
ATAGCGTACGACCATATAGT -> TAGCGTACGACCATATAGTC
TCGTATATGGGATTTCATAG -> CGTATATGGGATTTCATAGC
AATGAGCCGCCTGGCAACTC -> ATGAGCCGCCTGGCAACTCG
ATCCTATTCCGCAGCGACCA -> TCCTATTCCGCAGCGACCAA
ACACGCAGGTGGTTACGGCC -> CACGCAGGTGGTTACGGCCT
CCAGGAACACTACCTGTAGG -> CAGGAACACTACCTGTAGGC
GGGATTTCATAGCACCCTAA -> GGATTTCATAGCACCCTAAT
TATAGCGGTTGGGGCACGGG -> ATAGCGGTTGGGGCACGGGG
AATGAACTGACTATCATAAC -> ATGAACTGACTATCATAACA
CTTGCCGCGTCAAAGGACGG -> TTGCCGCGTCAAAGGACGGG
CAGTAATGCGGTCTAGTGAA -> AGTAATGCGGTCTAGTGAAG
ATGGGATTTCATAGCACCCT -> TGGGATTTCATAGCACCCTA
CGTTGGGCAAGTACCCCCTA -> GTTGGGCAAGTACCCCCTAA
ACTAAGGTTCCAGCCCAGCG -> CTAAGGTTCCAGCCCAGCGC
GGTTGGGGCACGGGGTCCGT -> GTTGGGGCACGGGGTCCGTC
ACCTGTAGGCGTCGGAGGCT -> CCTGTAGGCGTCGGAGGCTT
AATTGTCTAGGACATTAAAC -> ATTGTCTAGGACATTAAACG
TCATAACATTAAACCCCAGC -> CATAACATTAAACCCCAGCT
TATAGTCATCAATCCAATCG -> ATAGTCATCAATCCAATCGC
CGTGGGCCCCCTGAAGCAAC -> GTGGGCCCCCTGAAGCAACA
TCCACCCGTACGTCGTACTG -> CCACCCGTACGTCGTACTGT
GTCGGAGGCTTGGGCTCCAG -> TCGGAGGCTTGGGCTCCAGG
CATAGCGTACGACCATATAG -> ATAGCGTACGACCATATAGT
CTTATTGTATCGTATAAGTT -> TTATTGTATCGTATAAGTTA
TGCTCCACCCGTACGTCGTA -> GCTCCACCCGTACGTCGTAC
TCCAGCCCAGCGCCGAATGC -> CCAGCCCAGCGCCGAATGCA
ACGGCCGGCGTTACCCCAAA -> CGGCCGGCGTTACCCCAAAC
CAGCCCAGCGCCGAATGCAT -> AGCCCAGCGCCGAATGCATA
TGCGGTGCACGTTTCCCCTA -> GCGGTGCACGTTTCCCCTAC
TAGCGGTTGGGGCACGGGGT -> AGCGGTTGGGGCACGGGGTC
AGACTCACGTCGATATTTTG -> GACTCACGTCGATATTTTGA
CGTTTACACATTCTGAGATG -> GTTTACACATTCTGAGATGT
TGAGATATTGCGCCGACACC -> GAGATATTGCGCCGACACCC
TTAAGGAGCGACGTACTAAG -> TAAGGAGCGACGTACTAAGG
CAACAGCGAGCTACTCCTCC -> AACAGCGAGCTACTCCTCCA
AGAGCTGCTGCATCTTGCCG -> GAGCTGCTGCATCTTGCCGC
AGCAACAGCGAGCTACTCCT -> GCAACAGCGAGCTACTCCTC
AAGCAACAGCGAGCTACTCC -> AGCAACAGCGAGCTACTCCT
AGGCGTCGGAGGCTTGGGCT -> GGCGTCGGAGGCTTGGGCTC
AGGTTGTCCCGAGGTATGGC -> GGTTGTCCCGAGGTATGGCT
GCTGGCCCCGTGCTTCCTCG -> CTGGCCCCGTGCTTCCTCGT
GCTCCGTAGCAACATCCCAA -> CTCCGTAGCAACATCCCAAT
AACTGACTATCATAACATTA -> ACTGACTATCATAACATTAA
ACGTTTCCCCTACGTGAGGT -> CGTTTCCCCTACGTGAGGTG
GGGCACGGGGTCCGTCCTAT -> GGCACGGGGTCCGTCCTATC
TTTAGGTTTTGAGCCTAGAG -> TTAGGTTTTGAGCCTAGAGC
TTCATAGCACCCTAATCGGT -> TCATAGCACCCTAATCGGTG
ATACAATGAACTGACTATCA -> TACAATGAACTGACTATCAT
TATTGCGCCGACACCCGCGT -> ATTGCGCCGACACCCGCGTA
AGGAGCGACGTACTAAGGTT -> GGAGCGACGTACTAAGGTTC
GGTCCGTCCTATCATCGTAT -> GTCCGTCCTATCATCGTATA
AGGACATTAAACGGCAAGTA -> GGACATTAAACGGCAAGTAG
AGTGCGGTGCACGTTTCCCC -> GTGCGGTGCACGTTTCCCCT
CCAATCCTATTCCGCAGCGA -> CAATCCTATTCCGCAGCGAC
ACGCCTTATTGTATCGTATA -> CGCCTTATTGTATCGTATAA
AACAGCGAGCTACTCCTCCA -> ACAGCGAGCTACTCCTCCAA
CGTCAAAGGACGGGCCGCGC -> GTCAAAGGACGGGCCGCGCA
TAAGGTTCCAGCCCAGCGCC -> AAGGTTCCAGCCCAGCGCCG
CGACGTTGGGCAAGTACCCC -> GACGTTGGGCAAGTACCCCC
AGATCACGTTTACACATTCT -> GATCACGTTTACACATTCTG
CGTCAACTTAAGGAGCGACG -> GTCAACTTAAGGAGCGACGT
TACACATTCTGAGATGTAGT -> ACACATTCTGAGATGTAGTG
TATAACAGTAATGCGGTCTA -> ATAACAGTAATGCGGTCTAG
CGGTGAATTGTCTAGGACAT -> GGTGAATTGTCTAGGACATT
TCAGATCCTTAAAGCTTGCA -> CAGATCCTTAAAGCTTGCAC
ATTCTGAGATGTAGTGCCCT -> TTCTGAGATGTAGTGCCCTA
AACCGTAACTCATAGCGTAC -> ACCGTAACTCATAGCGTACG
CCAGCGCCGAATGCATACAA -> CAGCGCCGAATGCATACAAT
GGTCTCACATGCGCGATGAA -> GTCTCACATGCGCGATGAAG
TGGGCCCCCTGAAGCAACAG -> GGGCCCCCTGAAGCAACAGC
GATGATGTGGTCTCACATGC -> ATGATGTGGTCTCACATGCG
AGCCTAGAGCTGCTGCATCT -> GCCTAGAGCTGCTGCATCTT
TAGGCGTCGGAGGCTTGGGC -> AGGCGTCGGAGGCTTGGGCT
CCTATTCCGCAGCGACCAAG -> CTATTCCGCAGCGACCAAGA
GTACTCAGATCCTTAAAGCT -> TACTCAGATCCTTAAAGCTT
ACGGCAAGTAGGCTGGCCCC -> CGGCAAGTAGGCTGGCCCCG
AGCGTATAGCGGTTGGGGCA -> GCGTATAGCGGTTGGGGCAC
CAGCGAGCTACTCCTCCAAG -> AGCGAGCTACTCCTCCAAGC
CGTATATGGGATTTCATAGC -> GTATATGGGATTTCATAGCA
ACCGTAACTCATAGCGTACG -> CCGTAACTCATAGCGTACGA
GCGGGCGGGCTCCGTCCATC -> CGGGCGGGCTCCGTCCATCT
TTGAGCCTAGAGCTGCTGCA -> TGAGCCTAGAGCTGCTGCAT
CTCTGTACTCAGATCCTTAA -> TCTGTACTCAGATCCTTAAA
GAGGTGCTCCACCCGTACGT -> AGGTGCTCCACCCGTACGTC
GCCGCCTGGCAACTCGAATC -> CCGCCTGGCAACTCGAATCG
CATATAGTCATCAATCCAAT -> ATATAGTCATCAATCCAATC
CTGTAGGCGTCGGAGGCTTG -> TGTAGGCGTCGGAGGCTTGG
TCGGTGAATTGTCTAGGACA -> CGGTGAATTGTCTAGGACAT
GGCTCCAGGTTGTCCCGAGG -> GCTCCAGGTTGTCCCGAGGT
AGGCTGGCCCCGTGCTTCCT -> GGCTGGCCCCGTGCTTCCTC
AGTGAAGAACTTTAGGTTTT -> GTGAAGAACTTTAGGTTTTG
ACATCCCAATCCTATTCCGC -> CATCCCAATCCTATTCCGCA
GCTCCGTCCATCTGATGGCC -> CTCCGTCCATCTGATGGCCC
CCCGACACTTTGCCTTTCCC -> CCGACACTTTGCCTTTCCCC
GTCGTACTGTTACGCGACAG -> TCGTACTGTTACGCGACAGA
TGAAGCATAAGCGTATAGCG -> GAAGCATAAGCGTATAGCGG
TTAGGTTTTGAGCCTAGAGC -> TAGGTTTTGAGCCTAGAGCT
TCTTTAGATGATGTGGTCTC -> CTTTAGATGATGTGGTCTCA
CTGTACTCAGATCCTTAAAG -> TGTACTCAGATCCTTAAAGC
CGAATGCATACAATGAACTG -> GAATGCATACAATGAACTGA
TTTCATAGCACCCTAATCGG -> TTCATAGCACCCTAATCGGT
TAGGTTTTGAGCCTAGAGCT -> AGGTTTTGAGCCTAGAGCTG
CGACAGAGTTCAATGAGCCG -> GACAGAGTTCAATGAGCCGC
CCGAACGTAAAAAACAGTCT -> CGAACGTAAAAAACAGTCTT
GCGTATAGCGGTTGGGGCAC -> CGTATAGCGGTTGGGGCACG
GAAGCATAAGCGTATAGCGG -> AAGCATAAGCGTATAGCGGT
ACGTGAGGTGCCGACCCGCT -> CGTGAGGTGCCGACCCGCTA
TATGGCTTCCACACGTCTGA -> ATGGCTTCCACACGTCTGAC
AATCCAATCGCGGTTGGAAT -> ATCCAATCGCGGTTGGAATC
CGTAAAAAACAGTCTTTAGA -> GTAAAAAACAGTCTTTAGAT
CGGGTGCACGCCTTATTGTA -> GGGTGCACGCCTTATTGTAT
CTACCTGTAGGCGTCGGAGG -> TACCTGTAGGCGTCGGAGGC
CGAATCGACGTTGGGCAAGT -> GAATCGACGTTGGGCAAGTA
GCTATGCTCCGAACGTAAAA -> CTATGCTCCGAACGTAAAAA
AATCGACGTTGGGCAAGTAC -> ATCGACGTTGGGCAAGTACC
GCCCAGCGCCGAATGCATAC -> CCCAGCGCCGAATGCATACA
ACAGTCTTTAGATGATGTGG -> CAGTCTTTAGATGATGTGGT
TATGGGATTTCATAGCACCC -> ATGGGATTTCATAGCACCCT
CCTTTCCCCTCGAGAGATCA -> CTTTCCCCTCGAGAGATCAC
CTTGCACCCGACACTTTGCC -> TTGCACCCGACACTTTGCCT
ACTCGAATCGACGTTGGGCA -> CTCGAATCGACGTTGGGCAA
GCGCCGACACCCGCGTATAG -> CGCCGACACCCGCGTATAGC
TTAAACGGCAAGTAGGCTGG -> TAAACGGCAAGTAGGCTGGC
GGCGTTACCCCAAACGCCAT -> GCGTTACCCCAAACGCCATA
TCATAGCGTACGACCATATA -> CATAGCGTACGACCATATAG
CATTAAACGGCAAGTAGGCT -> ATTAAACGGCAAGTAGGCTG
AGGTTTTGAGCCTAGAGCTG -> GGTTTTGAGCCTAGAGCTGC
AACTTTAGGTTTTGAGCCTA -> ACTTTAGGTTTTGAGCCTAG
ATAGTCATCAATCCAATCGC -> TAGTCATCAATCCAATCGCG
AGCGGTTGGGGCACGGGGTC -> GCGGTTGGGGCACGGGGTCC
CTTAAGGAGCGACGTACTAA -> TTAAGGAGCGACGTACTAAG
CGGGCCGCGCAGCCCAGGAA -> GGGCCGCGCAGCCCAGGAAC
GGACATTAAACGGCAAGTAG -> GACATTAAACGGCAAGTAGG
AACAGTAATGCGGTCTAGTG -> ACAGTAATGCGGTCTAGTGA
GCTGCTGCATCTTGCCGCGT -> CTGCTGCATCTTGCCGCGTC
CAGGTGGTTACGGCCTAGTT -> AGGTGGTTACGGCCTAGTTG
CCGAATGCATACAATGAACT -> CGAATGCATACAATGAACTG
TCACGTTTACACATTCTGAG -> CACGTTTACACATTCTGAGA
CATGCTGAGTGCGGTGCACG -> ATGCTGAGTGCGGTGCACGT
ACCCCAGCTCCGTAGCAACA -> CCCCAGCTCCGTAGCAACAT
TGTTACGCGACAGAGTTCAA -> GTTACGCGACAGAGTTCAAT
TCCGAACGTAAAAAACAGTC -> CCGAACGTAAAAAACAGTCT
CGACCAAGAGCTATGCTCCG -> GACCAAGAGCTATGCTCCGA
GATGTGGTCTCACATGCGCG -> ATGTGGTCTCACATGCGCGA
ACGTCTGACGTCAACTTAAG -> CGTCTGACGTCAACTTAAGG
ACAGAGTTCAATGAGCCGCC -> CAGAGTTCAATGAGCCGCCT
CCCCTCGGCCCACGTGGGCC -> CCCTCGGCCCACGTGGGCCC
AAACGGCAAGTAGGCTGGCC -> AACGGCAAGTAGGCTGGCCC
TACGTCGTACTGTTACGCGA -> ACGTCGTACTGTTACGCGAC
CCGCCTGGCAACTCGAATCG -> CGCCTGGCAACTCGAATCGA
TGCATCTTGCCGCGTCAAAG -> GCATCTTGCCGCGTCAAAGG
GCTCCACCCGTACGTCGTAC -> CTCCACCCGTACGTCGTACT
TAGGACATTAAACGGCAAGT -> AGGACATTAAACGGCAAGTA
CCTCGAGAGATCACGTTTAC -> CTCGAGAGATCACGTTTACA
GCAACTCGAATCGACGTTGG -> CAACTCGAATCGACGTTGGG
CCCCAGCTCCGTAGCAACAT -> CCCAGCTCCGTAGCAACATC
CAAGAGCTATGCTCCGAACG -> AAGAGCTATGCTCCGAACGT
GTGAAGAACTTTAGGTTTTG -> TGAAGAACTTTAGGTTTTGA
AGCATGCTGAGTGCGGTGCA -> GCATGCTGAGTGCGGTGCAC
TTAAAGCTTGCACCCGACAC -> TAAAGCTTGCACCCGACACT
CCCAGGAACACTACCTGTAG -> CCAGGAACACTACCTGTAGG
CTAAGGTTCCAGCCCAGCGC -> TAAGGTTCCAGCCCAGCGCC
TTCCACACGTCTGACGTCAA -> TCCACACGTCTGACGTCAAC
ATCCTTGTGACGGCCGGCGT -> TCCTTGTGACGGCCGGCGTT
ACGGCCTAGTTGGAGGTGCT -> CGGCCTAGTTGGAGGTGCTC
CTCGTGAGATATTGCGCCGA -> TCGTGAGATATTGCGCCGAC
ACCCGCTATAACAGTAATGC -> CCCGCTATAACAGTAATGCG
CCCAAACGCCATACGCCAGA -> CCAAACGCCATACGCCAGAC
CCCTACGTGAGGTGCCGACC -> CCTACGTGAGGTGCCGACCC
GTCTCTGTACTCAGATCCTT -> TCTCTGTACTCAGATCCTTA
GCATACAATGAACTGACTAT -> CATACAATGAACTGACTATC
ACAGCGAGCTACTCCTCCAA -> CAGCGAGCTACTCCTCCAAG
GAACACTACCTGTAGGCGTC -> AACACTACCTGTAGGCGTCG
ACACTTTGCCTTTCCCCTCG -> CACTTTGCCTTTCCCCTCGA
TGCCGCGTCAAAGGACGGGC -> GCCGCGTCAAAGGACGGGCC
GACGTTGGGCAAGTACCCCC -> ACGTTGGGCAAGTACCCCCT
GGCCGGCGTTACCCCAAACG -> GCCGGCGTTACCCCAAACGC
AGTAATGCGGTCTAGTGAAG -> GTAATGCGGTCTAGTGAAGA
ACGCCATACGCCAGACTCAC -> CGCCATACGCCAGACTCACG
GCAAGTAGGCTGGCCCCGTG -> CAAGTAGGCTGGCCCCGTGC
CCAAACGCCATACGCCAGAC -> CAAACGCCATACGCCAGACT
CACCCGCGTATAGCGGGCGG -> ACCCGCGTATAGCGGGCGGG
AGCGTACGACCATATAGTCA -> GCGTACGACCATATAGTCAT
TTTGCCTTTCCCCTCGAGAG -> TTGCCTTTCCCCTCGAGAGA
AGCTCCGTAGCAACATCCCA -> GCTCCGTAGCAACATCCCAA
GGATTTCATAGCACCCTAAT -> GATTTCATAGCACCCTAATC
GCCTAGTTGGAGGTGCTCCA -> CCTAGTTGGAGGTGCTCCAC
GGAGGTGCTCCACCCGTACG -> GAGGTGCTCCACCCGTACGT
CGTTACCCCAAACGCCATAC -> GTTACCCCAAACGCCATACG
CCTATCATCGTATATGGGAT -> CTATCATCGTATATGGGATT
TACCTGTAGGCGTCGGAGGC -> ACCTGTAGGCGTCGGAGGCT
CCGACACTTTGCCTTTCCCC -> CGACACTTTGCCTTTCCCCT
CTGATGGCCCATCCTTGTGA -> TGATGGCCCATCCTTGTGAC
CACATGCGCGATGAAGCATA -> ACATGCGCGATGAAGCATAA
TGTGACGGCCGGCGTTACCC -> GTGACGGCCGGCGTTACCCC
CCGCGTCAAAGGACGGGCCG -> CGCGTCAAAGGACGGGCCGC
AACTTAAGGAGCGACGTACT -> ACTTAAGGAGCGACGTACTA
TCCGTCCATCTGATGGCCCA -> CCGTCCATCTGATGGCCCAT
CATACGCCAGACTCACGTCG -> ATACGCCAGACTCACGTCGA
GATCACGTTTACACATTCTG -> ATCACGTTTACACATTCTGA
GCGCCGAATGCATACAATGA -> CGCCGAATGCATACAATGAA
GACACTTTGCCTTTCCCCTC -> ACACTTTGCCTTTCCCCTCG
AAGGACGGGCCGCGCAGCCC -> AGGACGGGCCGCGCAGCCCA
ATATTGCGCCGACACCCGCG -> TATTGCGCCGACACCCGCGT
ACGGGGTCCGTCCTATCATC -> CGGGGTCCGTCCTATCATCG
CCCAGCTCCGTAGCAACATC -> CCAGCTCCGTAGCAACATCC
AGTCTTTAGATGATGTGGTC -> GTCTTTAGATGATGTGGTCT
TCTGTACTCAGATCCTTAAA -> CTGTACTCAGATCCTTAAAG
GATATTGCGCCGACACCCGC -> ATATTGCGCCGACACCCGCG
CCTGGCAACTCGAATCGACG -> CTGGCAACTCGAATCGACGT
TGTCCCGAGGTATGGCTTCC -> GTCCCGAGGTATGGCTTCCA
GTGGTTACGGCCTAGTTGGA -> TGGTTACGGCCTAGTTGGAG
GGGGTCCGTCCTATCATCGT -> GGGTCCGTCCTATCATCGTA
TCTGACGTCAACTTAAGGAG -> CTGACGTCAACTTAAGGAGC
ATGTAGTGCCCTAACCTACC -> TGTAGTGCCCTAACCTACCG
TGATGTGGTCTCACATGCGC -> GATGTGGTCTCACATGCGCG
ACCAAGAGCTATGCTCCGAA -> CCAAGAGCTATGCTCCGAAC
AAACAGTCTTTAGATGATGT -> AACAGTCTTTAGATGATGTG
TGAGGTGCCGACCCGCTATA -> GAGGTGCCGACCCGCTATAA
ACGCAGGTGGTTACGGCCTA -> CGCAGGTGGTTACGGCCTAG
ATGCATACAATGAACTGACT -> TGCATACAATGAACTGACTA
TGCTCCGAACGTAAAAAACA -> GCTCCGAACGTAAAAAACAG
TAGCAACATCCCAATCCTAT -> AGCAACATCCCAATCCTATT
GGTATGGCTTCCACACGTCT -> GTATGGCTTCCACACGTCTG
AGGTGCTCCACCCGTACGTC -> GGTGCTCCACCCGTACGTCG
ATCATAACATTAAACCCCAG -> TCATAACATTAAACCCCAGC
CTGAGATGTAGTGCCCTAAC -> TGAGATGTAGTGCCCTAACC
CCCTAACAACCGTAACTCAT -> CCTAACAACCGTAACTCATA
CTCCGAACGTAAAAAACAGT -> TCCGAACGTAAAAAACAGTC
GGCCGCGCAGCCCAGGAACA -> GCCGCGCAGCCCAGGAACAC
GGAGCGACGTACTAAGGTTC -> GAGCGACGTACTAAGGTTCC
GCGCAGCCCAGGAACACTAC -> CGCAGCCCAGGAACACTACC
GTGAGATATTGCGCCGACAC -> TGAGATATTGCGCCGACACC
TCGTATAAGTTAGCCCCCTC -> CGTATAAGTTAGCCCCCTCG
GGGTCCGTCCTATCATCGTA -> GGTCCGTCCTATCATCGTAT
ACATTAAACGGCAAGTAGGC -> CATTAAACGGCAAGTAGGCT
ATCAATCCAATCGCGGTTGG -> TCAATCCAATCGCGGTTGGA
CAAACGCCATACGCCAGACT -> AAACGCCATACGCCAGACTC
CGGTTGGGGCACGGGGTCCG -> GGTTGGGGCACGGGGTCCGT
TCGGCCCACGTGGGCCCCCT -> CGGCCCACGTGGGCCCCCTG
CCCCTCGAGAGATCACGTTT -> CCCTCGAGAGATCACGTTTA
AGATATTGCGCCGACACCCG -> GATATTGCGCCGACACCCGC
TAAACCCCAGCTCCGTAGCA -> AAACCCCAGCTCCGTAGCAA
TAAGCGTATAGCGGTTGGGG -> AAGCGTATAGCGGTTGGGGC
GGCGTCGGAGGCTTGGGCTC -> GCGTCGGAGGCTTGGGCTCC
TGAGATGTAGTGCCCTAACC -> GAGATGTAGTGCCCTAACCT
GAACTGACTATCATAACATT -> AACTGACTATCATAACATTA
ATCGGTGAATTGTCTAGGAC -> TCGGTGAATTGTCTAGGACA
ACGTTTACACATTCTGAGAT -> CGTTTACACATTCTGAGATG
CCGTACGTCGTACTGTTACG -> CGTACGTCGTACTGTTACGC
CATTAAACCCCAGCTCCGTA -> ATTAAACCCCAGCTCCGTAG
CGTGCTTCCTCGTGAGATAT -> GTGCTTCCTCGTGAGATATT
CTGCATCTTGCCGCGTCAAA -> TGCATCTTGCCGCGTCAAAG
ATGGCCCATCCTTGTGACGG -> TGGCCCATCCTTGTGACGGC
TGAGCCGCCTGGCAACTCGA -> GAGCCGCCTGGCAACTCGAA
GGTGCACGCCTTATTGTATC -> GTGCACGCCTTATTGTATCG
AGTTGGAGGTGCTCCACCCG -> GTTGGAGGTGCTCCACCCGT
GATCCTTAAAGCTTGCACCC -> ATCCTTAAAGCTTGCACCCG
CTCATAGCGTACGACCATAT -> TCATAGCGTACGACCATATA
GCACGCCTTATTGTATCGTA -> CACGCCTTATTGTATCGTAT
GTACGTCGTACTGTTACGCG -> TACGTCGTACTGTTACGCGA
GTGCTTCCTCGTGAGATATT -> TGCTTCCTCGTGAGATATTG
GCAGCGACCAAGAGCTATGC -> CAGCGACCAAGAGCTATGCT
CTGAGTGCGGTGCACGTTTC -> TGAGTGCGGTGCACGTTTCC
TACGCGACAGAGTTCAATGA -> ACGCGACAGAGTTCAATGAG
GTAGCAACATCCCAATCCTA -> TAGCAACATCCCAATCCTAT
CTACGTGAGGTGCCGACCCG -> TACGTGAGGTGCCGACCCGC
CCTAGTTGGAGGTGCTCCAC -> CTAGTTGGAGGTGCTCCACC
CCATCCTTGTGACGGCCGGC -> CATCCTTGTGACGGCCGGCG
CTACTCCTCCAAGCATGCTG -> TACTCCTCCAAGCATGCTGA
CTACCGGGTGCACGCCTTAT -> TACCGGGTGCACGCCTTATT
CCTACGTGAGGTGCCGACCC -> CTACGTGAGGTGCCGACCCG
CAAGTAGGCTGGCCCCGTGC -> AAGTAGGCTGGCCCCGTGCT
GCTTGCACCCGACACTTTGC -> CTTGCACCCGACACTTTGCC
AACAGTCTTTAGATGATGTG -> ACAGTCTTTAGATGATGTGG
TAGTGCCCTAACCTACCGGG -> AGTGCCCTAACCTACCGGGT
CATAAGCGTATAGCGGTTGG -> ATAAGCGTATAGCGGTTGGG
CACACGTCTGACGTCAACTT -> ACACGTCTGACGTCAACTTA
GCCCCGTGCTTCCTCGTGAG -> CCCCGTGCTTCCTCGTGAGA
GCCATACGCCAGACTCACGT -> CCATACGCCAGACTCACGTC
GAGAGATCACGTTTACACAT -> AGAGATCACGTTTACACATT
CTCCGTCCATCTGATGGCCC -> TCCGTCCATCTGATGGCCCA
ATGCTGAGTGCGGTGCACGT -> TGCTGAGTGCGGTGCACGTT
ACGTACTAAGGTTCCAGCCC -> CGTACTAAGGTTCCAGCCCA
TCTGAGATGTAGTGCCCTAA -> CTGAGATGTAGTGCCCTAAC
GCATGCTGAGTGCGGTGCAC -> CATGCTGAGTGCGGTGCACG
CGATGAAGCATAAGCGTATA -> GATGAAGCATAAGCGTATAG
GGCCTAGTTGGAGGTGCTCC -> GCCTAGTTGGAGGTGCTCCA
ACCCGTACGTCGTACTGTTA -> CCCGTACGTCGTACTGTTAC
TTCCCCTCGAGAGATCACGT -> TCCCCTCGAGAGATCACGTT
GGACGGGCCGCGCAGCCCAG -> GACGGGCCGCGCAGCCCAGG
TGTAGGCGTCGGAGGCTTGG -> GTAGGCGTCGGAGGCTTGGG
CAGCTCCGTAGCAACATCCC -> AGCTCCGTAGCAACATCCCA
AAGAGCTATGCTCCGAACGT -> AGAGCTATGCTCCGAACGTA
CGCCGACACCCGCGTATAGC -> GCCGACACCCGCGTATAGCG
AAGCGTATAGCGGTTGGGGC -> AGCGTATAGCGGTTGGGGCA
AACGTAAAAAACAGTCTTTA -> ACGTAAAAAACAGTCTTTAG
TCCAATCGCGGTTGGAATCG -> CCAATCGCGGTTGGAATCGC
GGCACGGGGTCCGTCCTATC -> GCACGGGGTCCGTCCTATCA
GGTGCACGTTTCCCCTACGT -> GTGCACGTTTCCCCTACGTG
ACCATATAGTCATCAATCCA -> CCATATAGTCATCAATCCAA
TGTCTAGGACATTAAACGGC -> GTCTAGGACATTAAACGGCA
GCCCCCTCGGCCCACGTGGG -> CCCCCTCGGCCCACGTGGGC
ATCGCGGTTGGAATCGCACT -> TCGCGGTTGGAATCGCACTG
ACGTTGGGCAAGTACCCCCT -> CGTTGGGCAAGTACCCCCTA
GTATCGTATAAGTTAGCCCC -> TATCGTATAAGTTAGCCCCC
