GCTCTTGGGCA -> CTCTTGGGCAG
CTCTTGGGCAG -> TCTTGGGCAGT
TCTTGGGCAGT -> CTTGGGCAGTA
CTTGGGCAGTA -> TTGGGCAGTAG
TTGGGCAGTAG -> TGGGCAGTAGA
TGGGCAGTAGA -> GGGCAGTAGAC
GGGCAGTAGAC -> GGCAGTAGACA
GGCAGTAGACA -> GCAGTAGACAC
GCAGTAGACAC -> CAGTAGACACG
CAGTAGACACG -> AGTAGACACGC
AGTAGACACGC -> GTAGACACGCG
GTAGACACGCG -> TAGACACGCGA
TAGACACGCGA -> AGACACGCGAT
AGACACGCGAT -> GACACGCGATC
GACACGCGATC -> ACACGCGATCT
ACACGCGATCT -> CACGCGATCTA
CACGCGATCTA -> ACGCGATCTAG
ACGCGATCTAG -> CGCGATCTAGA
CGCGATCTAGA -> GCGATCTAGAA
GCGATCTAGAA -> CGATCTAGAAT
CGATCTAGAAT -> GATCTAGAATG
GATCTAGAATG -> ATCTAGAATGG
ATCTAGAATGG -> TCTAGAATGGC
TCTAGAATGGC -> CTAGAATGGCA
CTAGAATGGCA -> TAGAATGGCAA
TAGAATGGCAA -> AGAATGGCAAC
AGAATGGCAAC -> GAATGGCAACC
GAATGGCAACC -> AATGGCAACCC
AATGGCAACCC -> ATGGCAACCCT
ATGGCAACCCT -> TGGCAACCCTG
TGGCAACCCTG -> GGCAACCCTGT
GGCAACCCTGT -> GCAACCCTGTC
GCAACCCTGTC -> CAACCCTGTCG
CAACCCTGTCG -> AACCCTGTCGA
AACCCTGTCGA -> ACCCTGTCGAT
ACCCTGTCGAT -> CCCTGTCGATG
CCCTGTCGATG -> CCTGTCGATGT
CCTGTCGATGT -> CTGTCGATGTT
CTGTCGATGTT -> TGTCGATGTTC
TGTCGATGTTC -> GTCGATGTTCT
GTCGATGTTCT -> TCGATGTTCTA
TCGATGTTCTA -> CGATGTTCTAA
CGATGTTCTAA -> GATGTTCTAAC
GATGTTCTAAC -> ATGTTCTAACA
ATGTTCTAACA -> TGTTCTAACAT
TGTTCTAACAT -> GTTCTAACATA
GTTCTAACATA -> TTCTAACATAA
TTCTAACATAA -> TCTAACATAAA
TCTAACATAAA -> CTAACATAAAG
CTAACATAAAG -> TAACATAAAGT
TAACATAAAGT -> AACATAAAGTG
AACATAAAGTG -> ACATAAAGTGA
ACATAAAGTGA -> CATAAAGTGAC
CATAAAGTGAC -> ATAAAGTGACG
ATAAAGTGACG -> TAAAGTGACGA
TAAAGTGACGA -> AAAGTGACGAT
AAAGTGACGAT -> AAGTGACGATG
AAGTGACGATG -> AGTGACGATGA
AGTGACGATGA -> GTGACGATGAG
GTGACGATGAG -> TGACGATGAGC
TGACGATGAGC -> GACGATGAGCC
GACGATGAGCC -> ACGATGAGCCA
ACGATGAGCCA -> CGATGAGCCAG
CGATGAGCCAG -> GATGAGCCAGC
GATGAGCCAGC -> ATGAGCCAGCG
ATGAGCCAGCG -> TGAGCCAGCGG
TGAGCCAGCGG -> GAGCCAGCGGT
GAGCCAGCGGT -> AGCCAGCGGTG
AGCCAGCGGTG -> GCCAGCGGTGT
GCCAGCGGTGT -> CCAGCGGTGTA
CCAGCGGTGTA -> CAGCGGTGTAT
CAGCGGTGTAT -> AGCGGTGTATA
AGCGGTGTATA -> GCGGTGTATAT
GCGGTGTATAT -> CGGTGTATATG
CGGTGTATATG -> GGTGTATATGG
GGTGTATATGG -> GTGTATATGGC
GTGTATATGGC -> TGTATATGGCT
TGTATATGGCT -> GTATATGGCTA
GTATATGGCTA -> TATATGGCTAA
TATATGGCTAA -> ATATGGCTAAA
ATATGGCTAAA -> TATGGCTAAAA
TATGGCTAAAA -> ATGGCTAAAAT
ATGGCTAAAAT -> TGGCTAAAATT
TGGCTAAAATT -> GGCTAAAATTA
GGCTAAAATTA -> GCTAAAATTAG
GCTAAAATTAG -> CTAAAATTAGA
CTAAAATTAGA -> TAAAATTAGAG
TAAAATTAGAG -> AAAATTAGAGA
AAAATTAGAGA -> AAATTAGAGAG
AAATTAGAGAG -> AATTAGAGAGA
AATTAGAGAGA -> ATTAGAGAGAC
ATTAGAGAGAC -> TTAGAGAGACA
TTAGAGAGACA -> TAGAGAGACAA
TAGAGAGACAA -> AGAGAGACAAC
AGAGAGACAAC -> GAGAGACAACT
GAGAGACAACT -> AGAGACAACTA
AGAGACAACTA -> GAGACAACTAT
GAGACAACTAT -> AGACAACTATT
AGACAACTATT -> GACAACTATTG
GACAACTATTG -> ACAACTATTGA
ACAACTATTGA -> CAACTATTGAA
CAACTATTGAA -> AACTATTGAAA
AACTATTGAAA -> ACTATTGAAAA
ACTATTGAAAA -> CTATTGAAAAC
CTATTGAAAAC -> TATTGAAAACC
TATTGAAAACC -> ATTGAAAACCG
ATTGAAAACCG -> TTGAAAACCGA
TTGAAAACCGA -> TGAAAACCGAC
TGAAAACCGAC -> GAAAACCGACT
GAAAACCGACT -> AAAACCGACTG
AAAACCGACTG -> AAACCGACTGC
AAACCGACTGC -> AACCGACTGCG
AACCGACTGCG -> ACCGACTGCGT
ACCGACTGCGT -> CCGACTGCGTA
CCGACTGCGTA -> CGACTGCGTAC
CGACTGCGTAC -> GACTGCGTACT
GACTGCGTACT -> ACTGCGTACTA
ACTGCGTACTA -> CTGCGTACTAA
CTGCGTACTAA -> TGCGTACTAAA
TGCGTACTAAA -> GCGTACTAAAT
GCGTACTAAAT -> CGTACTAAATA
CGTACTAAATA -> GTACTAAATAG
GTACTAAATAG -> TACTAAATAGA
TACTAAATAGA -> ACTAAATAGAT
ACTAAATAGAT -> CTAAATAGATA
CTAAATAGATA -> TAAATAGATAA
TAAATAGATAA -> AAATAGATAAA
AAATAGATAAA -> AATAGATAAAC
AATAGATAAAC -> ATAGATAAACG
ATAGATAAACG -> TAGATAAACGA
TAGATAAACGA -> AGATAAACGAA
AGATAAACGAA -> GATAAACGAAC
GATAAACGAAC -> ATAAACGAACC
ATAAACGAACC -> TAAACGAACCC
TAAACGAACCC -> AAACGAACCCC
AAACGAACCCC -> AACGAACCCCA
AACGAACCCCA -> ACGAACCCCAC
ACGAACCCCAC -> CGAACCCCACT
CGAACCCCACT -> GAACCCCACTA
GAACCCCACTA -> AACCCCACTAG
AACCCCACTAG -> ACCCCACTAGA
ACCCCACTAGA -> CCCCACTAGAG
CCCCACTAGAG -> CCCACTAGAGG
CCCACTAGAGG -> CCACTAGAGGG
CCACTAGAGGG -> CACTAGAGGGT
CACTAGAGGGT -> ACTAGAGGGTC
ACTAGAGGGTC -> CTAGAGGGTCT
CTAGAGGGTCT -> TAGAGGGTCTA
TAGAGGGTCTA -> AGAGGGTCTAT
AGAGGGTCTAT -> GAGGGTCTATG
GAGGGTCTATG -> AGGGTCTATGA
AGGGTCTATGA -> GGGTCTATGAA
GGGTCTATGAA -> GGTCTATGAAT
GGTCTATGAAT -> GTCTATGAATG
GTCTATGAATG -> TCTATGAATGG
TCTATGAATGG -> CTATGAATGGA
CTATGAATGGA -> TATGAATGGAG
TATGAATGGAG -> ATGAATGGAGC
ATGAATGGAGC -> TGAATGGAGCT
TGAATGGAGCT -> GAATGGAGCTG
GAATGGAGCTG -> AATGGAGCTGG
AATGGAGCTGG -> ATGGAGCTGGA
ATGGAGCTGGA -> TGGAGCTGGAC
TGGAGCTGGAC -> GGAGCTGGACG
GGAGCTGGACG -> GAGCTGGACGT
GAGCTGGACGT -> AGCTGGACGTT
AGCTGGACGTT -> GCTGGACGTTG
GCTGGACGTTG -> CTGGACGTTGA
CTGGACGTTGA -> TGGACGTTGAG
TGGACGTTGAG -> GGACGTTGAGT
GGACGTTGAGT -> GACGTTGAGTT
GACGTTGAGTT -> ACGTTGAGTTG
ACGTTGAGTTG -> CGTTGAGTTGG
CGTTGAGTTGG -> GTTGAGTTGGA
GTTGAGTTGGA -> TTGAGTTGGAA
TTGAGTTGGAA -> TGAGTTGGAAT
TGAGTTGGAAT -> GAGTTGGAATG
GAGTTGGAATG -> AGTTGGAATGA
AGTTGGAATGA -> GTTGGAATGAG
GTTGGAATGAG -> TTGGAATGAGG
TTGGAATGAGG -> TGGAATGAGGT
TGGAATGAGGT -> GGAATGAGGTG
GGAATGAGGTG -> GAATGAGGTGA
GAATGAGGTGA -> AATGAGGTGAT
AATGAGGTGAT -> ATGAGGTGATA
ATGAGGTGATA -> TGAGGTGATAC
TGAGGTGATAC -> GAGGTGATACC
GAGGTGATACC -> AGGTGATACCA
AGGTGATACCA -> GGTGATACCAT
GGTGATACCAT -> GTGATACCATT
GTGATACCATT -> TGATACCATTA
TGATACCATTA -> GATACCATTAA
GATACCATTAA -> ATACCATTAAA
ATACCATTAAA -> TACCATTAAAT
TACCATTAAAT -> ACCATTAAATC
ACCATTAAATC -> CCATTAAATCG
CCATTAAATCG -> CATTAAATCGG
CATTAAATCGG -> ATTAAATCGGA
ATTAAATCGGA -> TTAAATCGGAG
TTAAATCGGAG -> TAAATCGGAGG
TAAATCGGAGG -> AAATCGGAGGC
AAATCGGAGGC -> AATCGGAGGCG
AATCGGAGGCG -> ATCGGAGGCGG
ATCGGAGGCGG -> TCGGAGGCGGC
TCGGAGGCGGC -> CGGAGGCGGCT
CGGAGGCGGCT -> GGAGGCGGCTT
GGAGGCGGCTT -> GAGGCGGCTTG
GAGGCGGCTTG -> AGGCGGCTTGC
AGGCGGCTTGC -> GGCGGCTTGCC
GGCGGCTTGCC -> GCGGCTTGCCA
GCGGCTTGCCA -> CGGCTTGCCAA
CGGCTTGCCAA -> GGCTTGCCAAA
GGCTTGCCAAA -> GCTTGCCAAAT
GCTTGCCAAAT -> CTTGCCAAATT
CTTGCCAAATT -> TTGCCAAATTT
TTGCCAAATTT -> TGCCAAATTTC
TGCCAAATTTC -> GCCAAATTTCA
GCCAAATTTCA -> CCAAATTTCAG
CCAAATTTCAG -> CAAATTTCAGA
CAAATTTCAGA -> AAATTTCAGAA
AAATTTCAGAA -> AATTTCAGAAG
AATTTCAGAAG -> ATTTCAGAAGA
ATTTCAGAAGA -> TTTCAGAAGAC
TTTCAGAAGAC -> TTCAGAAGACA
TTCAGAAGACA -> TCAGAAGACAT
TCAGAAGACAT -> CAGAAGACATC
CAGAAGACATC -> AGAAGACATCC
AGAAGACATCC -> GAAGACATCCG
GAAGACATCCG -> AAGACATCCGA
AAGACATCCGA -> AGACATCCGAG
AGACATCCGAG -> GACATCCGAGG
GACATCCGAGG -> ACATCCGAGGG
ACATCCGAGGG -> CATCCGAGGGA
CATCCGAGGGA -> ATCCGAGGGAC
ATCCGAGGGAC -> TCCGAGGGACC
TCCGAGGGACC -> CCGAGGGACCG
CCGAGGGACCG -> CGAGGGACCGT
CGAGGGACCGT -> GAGGGACCGTC
GAGGGACCGTC -> AGGGACCGTCG
AGGGACCGTCG -> GGGACCGTCGA
GGGACCGTCGA -> GGACCGTCGAG
GGACCGTCGAG -> GACCGTCGAGC
GACCGTCGAGC -> ACCGTCGAGCA
ACCGTCGAGCA -> CCGTCGAGCAT
CCGTCGAGCAT -> CGTCGAGCATG
CGTCGAGCATG -> GTCGAGCATGC
GTCGAGCATGC -> TCGAGCATGCG
TCGAGCATGCG -> CGAGCATGCGA
CGAGCATGCGA -> GAGCATGCGAA
GAGCATGCGAA -> AGCATGCGAAA
AGCATGCGAAA -> GCATGCGAAAC
GCATGCGAAAC -> CATGCGAAACC
CATGCGAAACC -> ATGCGAAACCA
ATGCGAAACCA -> TGCGAAACCAC
TGCGAAACCAC -> GCGAAACCACT
GCGAAACCACT -> CGAAACCACTG
CGAAACCACTG -> GAAACCACTGG
GAAACCACTGG -> AAACCACTGGT
AAACCACTGGT -> AACCACTGGTC
AACCACTGGTC -> ACCACTGGTCC
ACCACTGGTCC -> CCACTGGTCCT
CCACTGGTCCT -> CACTGGTCCTT
CACTGGTCCTT -> ACTGGTCCTTG
ACTGGTCCTTG -> CTGGTCCTTGT
CTGGTCCTTGT -> TGGTCCTTGTC
TGGTCCTTGTC -> GGTCCTTGTCC
GGTCCTTGTCC -> GTCCTTGTCCT
GTCCTTGTCCT -> TCCTTGTCCTA
TCCTTGTCCTA -> CCTTGTCCTAT
CCTTGTCCTAT -> CTTGTCCTATC
CTTGTCCTATC -> TTGTCCTATCG
TTGTCCTATCG -> TGTCCTATCGG
TGTCCTATCGG -> GTCCTATCGGG
GTCCTATCGGG -> TCCTATCGGGC
TCCTATCGGGC -> CCTATCGGGCG
CCTATCGGGCG -> CTATCGGGCGC
CTATCGGGCGC -> TATCGGGCGCA
TATCGGGCGCA -> ATCGGGCGCAG
ATCGGGCGCAG -> TCGGGCGCAGC
TCGGGCGCAGC -> CGGGCGCAGCG
CGGGCGCAGCG -> GGGCGCAGCGC
GGGCGCAGCGC -> GGCGCAGCGCC
GGCGCAGCGCC -> GCGCAGCGCCG
GCGCAGCGCCG -> CGCAGCGCCGC
CGCAGCGCCGC -> GCAGCGCCGCT
GCAGCGCCGCT -> CAGCGCCGCTC
CAGCGCCGCTC -> AGCGCCGCTCG
AGCGCCGCTCG -> GCGCCGCTCGA
GCGCCGCTCGA -> CGCCGCTCGAT
CGCCGCTCGAT -> GCCGCTCGATC
GCCGCTCGATC -> CCGCTCGATCA
CCGCTCGATCA -> CGCTCGATCAG
CGCTCGATCAG -> GCTCGATCAGC
GCTCGATCAGC -> CTCGATCAGCG
CTCGATCAGCG -> TCGATCAGCGT
TCGATCAGCGT -> CGATCAGCGTG
CGATCAGCGTG -> GATCAGCGTGG
GATCAGCGTGG -> ATCAGCGTGGA
ATCAGCGTGGA -> TCAGCGTGGAG
TCAGCGTGGAG -> CAGCGTGGAGT
CAGCGTGGAGT -> AGCGTGGAGTC
AGCGTGGAGTC -> GCGTGGAGTCA
GCGTGGAGTCA -> CGTGGAGTCAT
CGTGGAGTCAT -> GTGGAGTCATC
GTGGAGTCATC -> TGGAGTCATCC
TGGAGTCATCC -> GGAGTCATCCA
GGAGTCATCCA -> GAGTCATCCAT
GAGTCATCCAT -> AGTCATCCATA
AGTCATCCATA -> GTCATCCATAC
GTCATCCATAC -> TCATCCATACT
TCATCCATACT -> CATCCATACTA
CATCCATACTA -> ATCCATACTAT
ATCCATACTAT -> TCCATACTATG
TCCATACTATG -> CCATACTATGC
CCATACTATGC -> CATACTATGCC
CATACTATGCC -> ATACTATGCCA
ATACTATGCCA -> TACTATGCCAA
TACTATGCCAA -> ACTATGCCAAC
ACTATGCCAAC -> CTATGCCAACA
CTATGCCAACA -> TATGCCAACAG
TATGCCAACAG -> ATGCCAACAGC
ATGCCAACAGC -> TGCCAACAGCC
TGCCAACAGCC -> GCCAACAGCCA
GCCAACAGCCA -> CCAACAGCCAA
CCAACAGCCAA -> CAACAGCCAAC
CAACAGCCAAC -> AACAGCCAACG
AACAGCCAACG -> ACAGCCAACGA
ACAGCCAACGA -> CAGCCAACGAT
CAGCCAACGAT -> AGCCAACGATT
AGCCAACGATT -> GCCAACGATTA
GCCAACGATTA -> CCAACGATTAA
CCAACGATTAA -> CAACGATTAAC
CAACGATTAAC -> AACGATTAACT
AACGATTAACT -> ACGATTAACTG
ACGATTAACTG -> CGATTAACTGG
CGATTAACTGG -> GATTAACTGGA
GATTAACTGGA -> ATTAACTGGAG
ATTAACTGGAG -> TTAACTGGAGA
TTAACTGGAGA -> TAACTGGAGAT
TAACTGGAGAT -> AACTGGAGATG
AACTGGAGATG -> ACTGGAGATGA
ACTGGAGATGA -> CTGGAGATGAG
CTGGAGATGAG -> TGGAGATGAGG
TGGAGATGAGG -> GGAGATGAGGG
GGAGATGAGGG -> GAGATGAGGGC
GAGATGAGGGC -> AGATGAGGGCC
AGATGAGGGCC -> GATGAGGGCCA
GATGAGGGCCA -> ATGAGGGCCAA
ATGAGGGCCAA -> TGAGGGCCAAG
TGAGGGCCAAG -> GAGGGCCAAGG
GAGGGCCAAGG -> AGGGCCAAGGT
AGGGCCAAGGT -> GGGCCAAGGTC
GGGCCAAGGTC -> GGCCAAGGTCA
GGCCAAGGTCA -> GCCAAGGTCAC
GCCAAGGTCAC -> CCAAGGTCACG
CCAAGGTCACG -> CAAGGTCACGA
CAAGGTCACGA -> AAGGTCACGAT
AAGGTCACGAT -> AGGTCACGATT
AGGTCACGATT -> GGTCACGATTT
GGTCACGATTT -> GTCACGATTTA
GTCACGATTTA -> TCACGATTTAT
TCACGATTTAT -> CACGATTTATC
CACGATTTATC -> ACGATTTATCG
ACGATTTATCG -> CGATTTATCGA
CGATTTATCGA -> GATTTATCGAT
GATTTATCGAT -> ATTTATCGATT
ATTTATCGATT -> TTTATCGATTG
TTTATCGATTG -> TTATCGATTGG
TTATCGATTGG -> TATCGATTGGG
TATCGATTGGG -> ATCGATTGGGG
ATCGATTGGGG -> TCGATTGGGGC
TCGATTGGGGC -> CGATTGGGGCG
CGATTGGGGCG -> GATTGGGGCGC
GATTGGGGCGC -> ATTGGGGCGCT
ATTGGGGCGCT -> TTGGGGCGCTT
TTGGGGCGCTT -> TGGGGCGCTTG
TGGGGCGCTTG -> GGGGCGCTTGG
GGGGCGCTTGG -> GGGCGCTTGGC
GGGCGCTTGGC -> GGCGCTTGGCA
GGCGCTTGGCA -> GCGCTTGGCAG
GCGCTTGGCAG -> CGCTTGGCAGG
CGCTTGGCAGG -> GCTTGGCAGGA
GCTTGGCAGGA -> CTTGGCAGGAA
CTTGGCAGGAA -> TTGGCAGGAAC
TTGGCAGGAAC -> TGGCAGGAACC
TGGCAGGAACC -> GGCAGGAACCG
GGCAGGAACCG -> GCAGGAACCGT
GCAGGAACCGT -> CAGGAACCGTG
CAGGAACCGTG -> AGGAACCGTGG
AGGAACCGTGG -> GGAACCGTGGT
GGAACCGTGGT -> GAACCGTGGTG
GAACCGTGGTG -> AACCGTGGTGA
AACCGTGGTGA -> ACCGTGGTGAA
ACCGTGGTGAA -> CCGTGGTGAAA
CCGTGGTGAAA -> CGTGGTGAAAG
CGTGGTGAAAG -> GTGGTGAAAGC
GTGGTGAAAGC -> TGGTGAAAGCT
TGGTGAAAGCT -> GGTGAAAGCTA
GGTGAAAGCTA -> GTGAAAGCTAC
GTGAAAGCTAC -> TGAAAGCTACA
TGAAAGCTACA -> GAAAGCTACAG
GAAAGCTACAG -> AAAGCTACAGC
AAAGCTACAGC -> AAGCTACAGCT
AAGCTACAGCT -> AGCTACAGCTC
AGCTACAGCTC -> GCTACAGCTCA
GCTACAGCTCA -> CTACAGCTCAA
CTACAGCTCAA -> TACAGCTCAAA
TACAGCTCAAA -> ACAGCTCAAAT
ACAGCTCAAAT -> CAGCTCAAATA
CAGCTCAAATA -> AGCTCAAATAT
AGCTCAAATAT -> GCTCAAATATT
GCTCAAATATT -> CTCAAATATTT
CTCAAATATTT -> TCAAATATTTC
TCAAATATTTC -> CAAATATTTCT
CAAATATTTCT -> AAATATTTCTG
AAATATTTCTG -> AATATTTCTGT
AATATTTCTGT -> ATATTTCTGTA
ATATTTCTGTA -> TATTTCTGTAC
TATTTCTGTAC -> ATTTCTGTACT
ATTTCTGTACT -> TTTCTGTACTG
TTTCTGTACTG -> TTCTGTACTGA
TTCTGTACTGA -> TCTGTACTGAT
TCTGTACTGAT -> CTGTACTGATG
CTGTACTGATG -> TGTACTGATGA
TGTACTGATGA -> GTACTGATGAA
GTACTGATGAA -> TACTGATGAAC
TACTGATGAAC -> ACTGATGAACT
ACTGATGAACT -> CTGATGAACTG
CTGATGAACTG -> TGATGAACTGC
TGATGAACTGC -> GATGAACTGCT
GATGAACTGCT -> ATGAACTGCTG
ATGAACTGCTG -> TGAACTGCTGG
TGAACTGCTGG -> GAACTGCTGGA
GAACTGCTGGA -> AACTGCTGGAA
AACTGCTGGAA -> ACTGCTGGAAG
ACTGCTGGAAG -> CTGCTGGAAGT
CTGCTGGAAGT -> TGCTGGAAGTA
TGCTGGAAGTA -> GCTGGAAGTAT
GCTGGAAGTAT -> CTGGAAGTATC
CTGGAAGTATC -> TGGAAGTATCG
TGGAAGTATCG -> GGAAGTATCGT
GGAAGTATCGT -> GAAGTATCGTA
GAAGTATCGTA -> AAGTATCGTAA
AAGTATCGTAA -> AGTATCGTAAT
AGTATCGTAAT -> GTATCGTAATT
GTATCGTAATT -> TATCGTAATTA
TATCGTAATTA -> ATCGTAATTAG
ATCGTAATTAG -> TCGTAATTAGT
TCGTAATTAGT -> CGTAATTAGTT
CGTAATTAGTT -> GTAATTAGTTG
GTAATTAGTTG -> TAATTAGTTGG
TAATTAGTTGG -> AATTAGTTGGT
AATTAGTTGGT -> ATTAGTTGGTT
ATTAGTTGGTT -> TTAGTTGGTTC
TTAGTTGGTTC -> TAGTTGGTTCC
TAGTTGGTTCC -> AGTTGGTTCCT
AGTTGGTTCCT -> GTTGGTTCCTG
GTTGGTTCCTG -> TTGGTTCCTGC
TTGGTTCCTGC -> TGGTTCCTGCG
TGGTTCCTGCG -> GGTTCCTGCGG
GGTTCCTGCGG -> GTTCCTGCGGA
GTTCCTGCGGA -> TTCCTGCGGAC
TTCCTGCGGAC -> TCCTGCGGACG
TCCTGCGGACG -> CCTGCGGACGG
CCTGCGGACGG -> CTGCGGACGGT
CTGCGGACGGT -> TGCGGACGGTT
TGCGGACGGTT -> GCGGACGGTTT
GCGGACGGTTT -> CGGACGGTTTG
CGGACGGTTTG -> GGACGGTTTGA
GGACGGTTTGA -> GACGGTTTGAC
GACGGTTTGAC -> ACGGTTTGACT
ACGGTTTGACT -> CGGTTTGACTC
CGGTTTGACTC -> GGTTTGACTCA
GGTTTGACTCA -> GTTTGACTCAC
GTTTGACTCAC -> TTTGACTCACG
TTTGACTCACG -> TTGACTCACGA
TTGACTCACGA -> TGACTCACGAA
TGACTCACGAA -> GACTCACGAAG
GACTCACGAAG -> ACTCACGAAGA
ACTCACGAAGA -> CTCACGAAGAT
CTCACGAAGAT -> TCACGAAGATT
TCACGAAGATT -> CACGAAGATTC
CACGAAGATTC -> ACGAAGATTCC
ACGAAGATTCC -> CGAAGATTCCA
CGAAGATTCCA -> GAAGATTCCAA
GAAGATTCCAA -> AAGATTCCAAA
AAGATTCCAAA -> AGATTCCAAAA
AGATTCCAAAA -> GATTCCAAAAA
GATTCCAAAAA -> ATTCCAAAAAC
ATTCCAAAAAC -> TTCCAAAAACT
TTCCAAAAACT -> TCCAAAAACTC
TCCAAAAACTC -> CCAAAAACTCG
CCAAAAACTCG -> CAAAAACTCGC
CAAAAACTCGC -> AAAAACTCGCT
AAAAACTCGCT -> AAAACTCGCTA
AAAACTCGCTA -> AAACTCGCTAC
AAACTCGCTAC -> AACTCGCTACG
AACTCGCTACG -> ACTCGCTACGC
ACTCGCTACGC -> CTCGCTACGCG
CTCGCTACGCG -> TCGCTACGCGA
TCGCTACGCGA -> CGCTACGCGAT
CGCTACGCGAT -> GCTACGCGATG
GCTACGCGATG -> CTACGCGATGG
CTACGCGATGG -> TACGCGATGGG
TACGCGATGGG -> ACGCGATGGGG
ACGCGATGGGG -> CGCGATGGGGG
CGCGATGGGGG -> GCGATGGGGGT
GCGATGGGGGT -> CGATGGGGGTA
CGATGGGGGTA -> GATGGGGGTAC
GATGGGGGTAC -> ATGGGGGTACT
ATGGGGGTACT -> TGGGGGTACTT
TGGGGGTACTT -> GGGGGTACTTG
GGGGGTACTTG -> GGGGTACTTGG
GGGGTACTTGG -> GGGTACTTGGA
GGGTACTTGGA -> GGTACTTGGAG
GGTACTTGGAG -> GTACTTGGAGG
GTACTTGGAGG -> TACTTGGAGGG
TACTTGGAGGG -> ACTTGGAGGGT
ACTTGGAGGGT -> CTTGGAGGGTA
CTTGGAGGGTA -> TTGGAGGGTAA
TTGGAGGGTAA -> TGGAGGGTAAG
TGGAGGGTAAG -> GGAGGGTAAGT
GGAGGGTAAGT -> GAGGGTAAGTT
GAGGGTAAGTT -> AGGGTAAGTTC
AGGGTAAGTTC -> GGGTAAGTTCT
GGGTAAGTTCT -> GGTAAGTTCTT
GGTAAGTTCTT -> GTAAGTTCTTG
GTAAGTTCTTG -> TAAGTTCTTGC
TAAGTTCTTGC -> AAGTTCTTGCA
AAGTTCTTGCA -> AGTTCTTGCAG
AGTTCTTGCAG -> GTTCTTGCAGG
GTTCTTGCAGG -> TTCTTGCAGGA
TTCTTGCAGGA -> TCTTGCAGGAA
TCTTGCAGGAA -> CTTGCAGGAAG
CTTGCAGGAAG -> TTGCAGGAAGT
TTGCAGGAAGT -> TGCAGGAAGTT
TGCAGGAAGTT -> GCAGGAAGTTA
GCAGGAAGTTA -> CAGGAAGTTAC
CAGGAAGTTAC -> AGGAAGTTACG
AGGAAGTTACG -> GGAAGTTACGT
GGAAGTTACGT -> GAAGTTACGTA
GAAGTTACGTA -> AAGTTACGTAG
AAGTTACGTAG -> AGTTACGTAGC
AGTTACGTAGC -> GTTACGTAGCT
GTTACGTAGCT -> TTACGTAGCTT
TTACGTAGCTT -> TACGTAGCTTA
TACGTAGCTTA -> ACGTAGCTTAT
ACGTAGCTTAT -> CGTAGCTTATT
CGTAGCTTATT -> GTAGCTTATTA
GTAGCTTATTA -> TAGCTTATTAG
TAGCTTATTAG -> AGCTTATTAGA
AGCTTATTAGA -> GCTTATTAGAC
GCTTATTAGAC -> CTTATTAGACA
CTTATTAGACA -> TTATTAGACAT
TTATTAGACAT -> TATTAGACATC
TATTAGACATC -> ATTAGACATCT
ATTAGACATCT -> TTAGACATCTA
TTAGACATCTA -> TAGACATCTAC
TAGACATCTAC -> AGACATCTACA
AGACATCTACA -> GACATCTACAC
GACATCTACAC -> ACATCTACACA
ACATCTACACA -> CATCTACACAT
CATCTACACAT -> ATCTACACATC
ATCTACACATC -> TCTACACATCT
TCTACACATCT -> CTACACATCTT
CTACACATCTT -> TACACATCTTC
TACACATCTTC -> ACACATCTTCG
ACACATCTTCG -> CACATCTTCGT
CACATCTTCGT -> ACATCTTCGTC
ACATCTTCGTC -> CATCTTCGTCT
CATCTTCGTCT -> ATCTTCGTCTA
ATCTTCGTCTA -> TCTTCGTCTAA
TCTTCGTCTAA -> CTTCGTCTAAC
CTTCGTCTAAC -> TTCGTCTAACC
TTCGTCTAACC -> TCGTCTAACCC
TCGTCTAACCC -> CGTCTAACCCG
CGTCTAACCCG -> GTCTAACCCGC
GTCTAACCCGC -> TCTAACCCGCT
TCTAACCCGCT -> CTAACCCGCTT
CTAACCCGCTT -> TAACCCGCTTG
TAACCCGCTTG -> AACCCGCTTGT
AACCCGCTTGT -> ACCCGCTTGTT
ACCCGCTTGTT -> CCCGCTTGTTG
CCCGCTTGTTG -> CCGCTTGTTGT
CCGCTTGTTGT -> CGCTTGTTGTC
CGCTTGTTGTC -> GCTTGTTGTCA
GCTTGTTGTCA -> CTTGTTGTCAC
CTTGTTGTCAC -> TTGTTGTCACG
TTGTTGTCACG -> TGTTGTCACGC
TGTTGTCACGC -> GTTGTCACGCG
GTTGTCACGCG -> TTGTCACGCGC
TTGTCACGCGC -> TGTCACGCGCT
TGTCACGCGCT -> GTCACGCGCTA
GTCACGCGCTA -> TCACGCGCTAG
TCACGCGCTAG -> CACGCGCTAGT
CACGCGCTAGT -> ACGCGCTAGTA
ACGCGCTAGTA -> CGCGCTAGTAA
CGCGCTAGTAA -> GCGCTAGTAAG
GCGCTAGTAAG -> CGCTAGTAAGG
CGCTAGTAAGG -> GCTAGTAAGGA
GCTAGTAAGGA -> CTAGTAAGGAC
CTAGTAAGGAC -> TAGTAAGGACC
TAGTAAGGACC -> AGTAAGGACCA
AGTAAGGACCA -> GTAAGGACCAT
GTAAGGACCAT -> TAAGGACCATA
TAAGGACCATA -> AAGGACCATAA
AAGGACCATAA -> AGGACCATAAC
AGGACCATAAC -> GGACCATAACT
GGACCATAACT -> GACCATAACTG
GACCATAACTG -> ACCATAACTGG
ACCATAACTGG -> CCATAACTGGC
CCATAACTGGC -> CATAACTGGCC
CATAACTGGCC -> ATAACTGGCCT
ATAACTGGCCT -> TAACTGGCCTC
TAACTGGCCTC -> AACTGGCCTCG
AACTGGCCTCG -> ACTGGCCTCGC
ACTGGCCTCGC -> CTGGCCTCGCA
CTGGCCTCGCA -> TGGCCTCGCAT
TGGCCTCGCAT -> GGCCTCGCATG
GGCCTCGCATG -> GCCTCGCATGA
GCCTCGCATGA -> CCTCGCATGAA
CCTCGCATGAA -> CTCGCATGAAC
CTCGCATGAAC -> TCGCATGAACA
TCGCATGAACA -> CGCATGAACAC
CGCATGAACAC -> GCATGAACACG
GCATGAACACG -> CATGAACACGC
CATGAACACGC -> ATGAACACGCG
ATGAACACGCG -> TGAACACGCGA
TGAACACGCGA -> GAACACGCGAA
GAACACGCGAA -> AACACGCGAAG
AACACGCGAAG -> ACACGCGAAGC
ACACGCGAAGC -> CACGCGAAGCG
CACGCGAAGCG -> ACGCGAAGCGA
ACGCGAAGCGA -> CGCGAAGCGAT
CGCGAAGCGAT -> GCGAAGCGATA
GCGAAGCGATA -> CGAAGCGATAA
CGAAGCGATAA -> GAAGCGATAAC
GAAGCGATAAC -> AAGCGATAACT
AAGCGATAACT -> AGCGATAACTA
AGCGATAACTA -> GCGATAACTAT
GCGATAACTAT -> CGATAACTATG
CGATAACTATG -> GATAACTATGT
GATAACTATGT -> ATAACTATGTG
ATAACTATGTG -> TAACTATGTGA
TAACTATGTGA -> AACTATGTGAC
AACTATGTGAC -> ACTATGTGACG
ACTATGTGACG -> CTATGTGACGT
CTATGTGACGT -> TATGTGACGTC
TATGTGACGTC -> ATGTGACGTCG
ATGTGACGTCG -> TGTGACGTCGC
TGTGACGTCGC -> GTGACGTCGCC
GTGACGTCGCC -> TGACGTCGCCA
TGACGTCGCCA -> GACGTCGCCAG
GACGTCGCCAG -> ACGTCGCCAGT
ACGTCGCCAGT -> CGTCGCCAGTG
CGTCGCCAGTG -> GTCGCCAGTGA
GTCGCCAGTGA -> TCGCCAGTGAT
TCGCCAGTGAT -> CGCCAGTGATC
CGCCAGTGATC -> GCCAGTGATCA
GCCAGTGATCA -> CCAGTGATCAC
CCAGTGATCAC -> CAGTGATCACT
CAGTGATCACT -> AGTGATCACTG
AGTGATCACTG -> GTGATCACTGA
GTGATCACTGA -> TGATCACTGAA
TGATCACTGAA -> GATCACTGAAG
GATCACTGAAG -> ATCACTGAAGC
ATCACTGAAGC -> TCACTGAAGCC
TCACTGAAGCC -> CACTGAAGCCC
CACTGAAGCCC -> ACTGAAGCCCC
ACTGAAGCCCC -> CTGAAGCCCCC
CTGAAGCCCCC -> TGAAGCCCCCC
TGAAGCCCCCC -> GAAGCCCCCCT
GAAGCCCCCCT -> AAGCCCCCCTG
AAGCCCCCCTG -> AGCCCCCCTGA
AGCCCCCCTGA -> GCCCCCCTGAA
GCCCCCCTGAA -> CCCCCCTGAAG
CCCCCCTGAAG -> CCCCCTGAAGT
CCCCCTGAAGT -> CCCCTGAAGTT
CCCCTGAAGTT -> CCCTGAAGTTG
CCCTGAAGTTG -> CCTGAAGTTGT
CCTGAAGTTGT -> CTGAAGTTGTA
CTGAAGTTGTA -> TGAAGTTGTAT
TGAAGTTGTAT -> GAAGTTGTATA
GAAGTTGTATA -> AAGTTGTATAC
AAGTTGTATAC -> AGTTGTATACG
AGTTGTATACG -> GTTGTATACGC
GTTGTATACGC -> TTGTATACGCA
TTGTATACGCA -> TGTATACGCAG
TGTATACGCAG -> GTATACGCAGG
GTATACGCAGG -> TATACGCAGGC
TATACGCAGGC -> ATACGCAGGCC
ATACGCAGGCC -> TACGCAGGCCG
TACGCAGGCCG -> ACGCAGGCCGC
ACGCAGGCCGC -> CGCAGGCCGCA
CGCAGGCCGCA -> GCAGGCCGCAC
GCAGGCCGCAC -> CAGGCCGCACG
CAGGCCGCACG -> AGGCCGCACGC
AGGCCGCACGC -> GGCCGCACGCG
GGCCGCACGCG -> GCCGCACGCGT
GCCGCACGCGT -> CCGCACGCGTC
CCGCACGCGTC -> CGCACGCGTCA
CGCACGCGTCA -> GCACGCGTCAC
GCACGCGTCAC -> CACGCGTCACA
CACGCGTCACA -> ACGCGTCACAT
ACGCGTCACAT -> CGCGTCACATT
CGCGTCACATT -> GCGTCACATTA
GCGTCACATTA -> CGTCACATTAT
CGTCACATTAT -> GTCACATTATT
GTCACATTATT -> TCACATTATTT
TCACATTATTT -> CACATTATTTA
CACATTATTTA -> ACATTATTTAA
ACATTATTTAA -> CATTATTTAAA
CATTATTTAAA -> ATTATTTAAAC
ATTATTTAAAC -> TTATTTAAACT
TTATTTAAACT -> TATTTAAACTA
TATTTAAACTA -> ATTTAAACTAT
ATTTAAACTAT -> TTTAAACTATG
TTTAAACTATG -> TTAAACTATGT
TTAAACTATGT -> TAAACTATGTG
TAAACTATGTG -> AAACTATGTGA
AAACTATGTGA -> AACTATGTGAT
AACTATGTGAT -> ACTATGTGATC
ACTATGTGATC -> CTATGTGATCC
CTATGTGATCC -> TATGTGATCCG
TATGTGATCCG -> ATGTGATCCGA
ATGTGATCCGA -> TGTGATCCGAT
TGTGATCCGAT -> GTGATCCGATT
GTGATCCGATT -> TGATCCGATTA
TGATCCGATTA -> GATCCGATTAT
GATCCGATTAT -> ATCCGATTATA
ATCCGATTATA -> TCCGATTATAC
TCCGATTATAC -> CCGATTATACT
CCGATTATACT -> CGATTATACTG
CGATTATACTG -> GATTATACTGC
GATTATACTGC -> ATTATACTGCC
ATTATACTGCC -> TTATACTGCCC
TTATACTGCCC -> TATACTGCCCA
TATACTGCCCA -> ATACTGCCCAA
ATACTGCCCAA -> TACTGCCCAAG
TACTGCCCAAG -> ACTGCCCAAGG
ACTGCCCAAGG -> CTGCCCAAGGG
CTGCCCAAGGG -> TGCCCAAGGGT
TGCCCAAGGGT -> GCCCAAGGGTT
GCCCAAGGGTT -> CCCAAGGGTTG
CCCAAGGGTTG -> CCAAGGGTTGA
CCAAGGGTTGA -> CAAGGGTTGAT
CAAGGGTTGAT -> AAGGGTTGATA
AAGGGTTGATA -> AGGGTTGATAC
AGGGTTGATAC -> GGGTTGATACT
GGGTTGATACT -> GGTTGATACTG
GGTTGATACTG -> GTTGATACTGA
GTTGATACTGA -> TTGATACTGAC
TTGATACTGAC -> TGATACTGACG
TGATACTGACG -> GATACTGACGA
GATACTGACGA -> ATACTGACGAA
ATACTGACGAA -> TACTGACGAAT
TACTGACGAAT -> ACTGACGAATT
ACTGACGAATT -> CTGACGAATTT
CTGACGAATTT -> TGACGAATTTA
TGACGAATTTA -> GACGAATTTAA
GACGAATTTAA -> ACGAATTTAAT
ACGAATTTAAT -> CGAATTTAATC
CGAATTTAATC -> GAATTTAATCG
GAATTTAATCG -> AATTTAATCGC
AATTTAATCGC -> ATTTAATCGCT
ATTTAATCGCT -> TTTAATCGCTC
TTTAATCGCTC -> TTAATCGCTCA
TTAATCGCTCA -> TAATCGCTCAG
TAATCGCTCAG -> AATCGCTCAGG
AATCGCTCAGG -> ATCGCTCAGGA
ATCGCTCAGGA -> TCGCTCAGGAG
TCGCTCAGGAG -> CGCTCAGGAGA
CGCTCAGGAGA -> GCTCAGGAGAG
GCTCAGGAGAG -> CTCAGGAGAGA
CTCAGGAGAGA -> TCAGGAGAGAT
TCAGGAGAGAT -> CAGGAGAGATA
CAGGAGAGATA -> AGGAGAGATAA
AGGAGAGATAA -> GGAGAGATAAC
GGAGAGATAAC -> GAGAGATAACC
GAGAGATAACC -> AGAGATAACCC
AGAGATAACCC -> GAGATAACCCG
GAGATAACCCG -> AGATAACCCGT
AGATAACCCGT -> GATAACCCGTC
GATAACCCGTC -> ATAACCCGTCC
ATAACCCGTCC -> TAACCCGTCCT
TAACCCGTCCT -> AACCCGTCCTT
AACCCGTCCTT -> ACCCGTCCTTT
ACCCGTCCTTT -> CCCGTCCTTTC
CCCGTCCTTTC -> CCGTCCTTTCT
CCGTCCTTTCT -> CGTCCTTTCTT
CGTCCTTTCTT -> GTCCTTTCTTA
GTCCTTTCTTA -> TCCTTTCTTAT
TCCTTTCTTAT -> CCTTTCTTATA
CCTTTCTTATA -> CTTTCTTATAG
CTTTCTTATAG -> TTTCTTATAGG
TTTCTTATAGG -> TTCTTATAGGC
TTCTTATAGGC -> TCTTATAGGCT
TCTTATAGGCT -> CTTATAGGCTT
CTTATAGGCTT -> TTATAGGCTTT
TTATAGGCTTT -> TATAGGCTTTG
TATAGGCTTTG -> ATAGGCTTTGG
ATAGGCTTTGG -> TAGGCTTTGGC
TAGGCTTTGGC -> AGGCTTTGGCA
AGGCTTTGGCA -> GGCTTTGGCAC
GGCTTTGGCAC -> GCTTTGGCACT
GCTTTGGCACT -> CTTTGGCACTG
CTTTGGCACTG -> TTTGGCACTGT
TTTGGCACTGT -> TTGGCACTGTC
TTGGCACTGTC -> TGGCACTGTCT
TGGCACTGTCT -> GGCACTGTCTA
GGCACTGTCTA -> GCACTGTCTAT
GCACTGTCTAT -> CACTGTCTATG
CACTGTCTATG -> ACTGTCTATGC
ACTGTCTATGC -> CTGTCTATGCT
CTGTCTATGCT -> TGTCTATGCTC
TGTCTATGCTC -> GTCTATGCTCT
GTCTATGCTCT -> TCTATGCTCTC
TCTATGCTCTC -> CTATGCTCTCA
CTATGCTCTCA -> TATGCTCTCAC
TATGCTCTCAC -> ATGCTCTCACC
ATGCTCTCACC -> TGCTCTCACCG
TGCTCTCACCG -> GCTCTCACCGA
GCTCTCACCGA -> CTCTCACCGAA
CTCTCACCGAA -> TCTCACCGAAG
TCTCACCGAAG -> CTCACCGAAGG
CTCACCGAAGG -> TCACCGAAGGT
TCACCGAAGGT -> CACCGAAGGTT
CACCGAAGGTT -> ACCGAAGGTTA
ACCGAAGGTTA -> CCGAAGGTTAC
CCGAAGGTTAC -> CGAAGGTTACA
CGAAGGTTACA -> GAAGGTTACAA
GAAGGTTACAA -> AAGGTTACAAG
AAGGTTACAAG -> AGGTTACAAGA
AGGTTACAAGA -> GGTTACAAGAG
GGTTACAAGAG -> GTTACAAGAGT
GTTACAAGAGT -> TTACAAGAGTG
TTACAAGAGTG -> TACAAGAGTGT
TACAAGAGTGT -> ACAAGAGTGTC
ACAAGAGTGTC -> CAAGAGTGTCG
CAAGAGTGTCG -> AAGAGTGTCGG
AAGAGTGTCGG -> AGAGTGTCGGG
AGAGTGTCGGG -> GAGTGTCGGGG
GAGTGTCGGGG -> AGTGTCGGGGG
AGTGTCGGGGG -> GTGTCGGGGGA
GTGTCGGGGGA -> TGTCGGGGGAT
TGTCGGGGGAT -> GTCGGGGGATC
GTCGGGGGATC -> TCGGGGGATCT
TCGGGGGATCT -> CGGGGGATCTT
CGGGGGATCTT -> GGGGGATCTTT
GGGGGATCTTT -> GGGGATCTTTT
GGGGATCTTTT -> GGGATCTTTTC
GGGATCTTTTC -> GGATCTTTTCA
GGATCTTTTCA -> GATCTTTTCAT
GATCTTTTCAT -> ATCTTTTCATG
ATCTTTTCATG -> TCTTTTCATGG
TCTTTTCATGG -> CTTTTCATGGC
CTTTTCATGGC -> TTTTCATGGCG
TTTTCATGGCG -> TTTCATGGCGG
TTTCATGGCGG -> TTCATGGCGGG
TTCATGGCGGG -> TCATGGCGGGC
TCATGGCGGGC -> CATGGCGGGCA
CATGGCGGGCA -> ATGGCGGGCAC
ATGGCGGGCAC -> TGGCGGGCACA
TGGCGGGCACA -> GGCGGGCACAG
GGCGGGCACAG -> GCGGGCACAGA
GCGGGCACAGA -> CGGGCACAGAT
CGGGCACAGAT -> GGGCACAGATA
GGGCACAGATA -> GGCACAGATAA
GGCACAGATAA -> GCACAGATAAG
GCACAGATAAG -> CACAGATAAGA
CACAGATAAGA -> ACAGATAAGAC
ACAGATAAGAC -> CAGATAAGACT
CAGATAAGACT -> AGATAAGACTA
AGATAAGACTA -> GATAAGACTAC
GATAAGACTAC -> ATAAGACTACC
ATAAGACTACC -> TAAGACTACCA
TAAGACTACCA -> AAGACTACCAT
AAGACTACCAT -> AGACTACCATC
AGACTACCATC -> GACTACCATCT
GACTACCATCT -> ACTACCATCTC
ACTACCATCTC -> CTACCATCTCA
CTACCATCTCA -> TACCATCTCAC
TACCATCTCAC -> ACCATCTCACT
ACCATCTCACT -> CCATCTCACTC
CCATCTCACTC -> CATCTCACTCG
CATCTCACTCG -> ATCTCACTCGG
ATCTCACTCGG -> TCTCACTCGGA
TCTCACTCGGA -> CTCACTCGGAC
CTCACTCGGAC -> TCACTCGGACC
TCACTCGGACC -> CACTCGGACCA
CACTCGGACCA -> ACTCGGACCAT
ACTCGGACCAT -> CTCGGACCATC
CTCGGACCATC -> TCGGACCATCC
TCGGACCATCC -> CGGACCATCCC
CGGACCATCCC -> GGACCATCCCT
GGACCATCCCT -> GACCATCCCTT
GACCATCCCTT -> ACCATCCCTTA
ACCATCCCTTA -> CCATCCCTTAG
CCATCCCTTAG -> CATCCCTTAGT
CATCCCTTAGT -> ATCCCTTAGTA
ATCCCTTAGTA -> TCCCTTAGTAT
TCCCTTAGTAT -> CCCTTAGTATT
CCCTTAGTATT -> CCTTAGTATTC
CCTTAGTATTC -> CTTAGTATTCG
CTTAGTATTCG -> TTAGTATTCGG
TTAGTATTCGG -> TAGTATTCGGC
TAGTATTCGGC -> AGTATTCGGCT
AGTATTCGGCT -> GTATTCGGCTA
GTATTCGGCTA -> TATTCGGCTAG
TATTCGGCTAG -> ATTCGGCTAGT
ATTCGGCTAGT -> TTCGGCTAGTT
TTCGGCTAGTT -> TCGGCTAGTTC
TCGGCTAGTTC -> CGGCTAGTTCA
CGGCTAGTTCA -> GGCTAGTTCAT
GGCTAGTTCAT -> GCTAGTTCATC
GCTAGTTCATC -> CTAGTTCATCG
CTAGTTCATCG -> TAGTTCATCGT
TAGTTCATCGT -> AGTTCATCGTC
AGTTCATCGTC -> GTTCATCGTCA
GTTCATCGTCA -> TTCATCGTCAC
TTCATCGTCAC -> TCATCGTCACC
TCATCGTCACC -> CATCGTCACCC
CATCGTCACCC -> ATCGTCACCCA
ATCGTCACCCA -> TCGTCACCCAG
TCGTCACCCAG -> CGTCACCCAGG
CGTCACCCAGG -> GTCACCCAGGT
GTCACCCAGGT -> TCACCCAGGTT
TCACCCAGGTT -> CACCCAGGTTC
CACCCAGGTTC -> ACCCAGGTTCA
ACCCAGGTTCA -> CCCAGGTTCAT
CCCAGGTTCAT -> CCAGGTTCATA
CCAGGTTCATA -> CAGGTTCATAT
CAGGTTCATAT -> AGGTTCATATA
AGGTTCATATA -> GGTTCATATAC
GGTTCATATAC -> GTTCATATACC
GTTCATATACC -> TTCATATACCT
TTCATATACCT -> TCATATACCTC
TCATATACCTC -> CATATACCTCT
CATATACCTCT -> ATATACCTCTC
ATATACCTCTC -> TATACCTCTCT
TATACCTCTCT -> ATACCTCTCTC
ATACCTCTCTC -> TACCTCTCTCA
TACCTCTCTCA -> ACCTCTCTCAC
ACCTCTCTCAC -> CCTCTCTCACT
CCTCTCTCACT -> CTCTCTCACTG
CTCTCTCACTG -> TCTCTCACTGC
TCTCTCACTGC -> CTCTCACTGCT
CTCTCACTGCT -> TCTCACTGCTC
TCTCACTGCTC -> CTCACTGCTCC
CTCACTGCTCC -> TCACTGCTCCA
TCACTGCTCCA -> CACTGCTCCAC
CACTGCTCCAC -> ACTGCTCCACC
ACTGCTCCACC -> CTGCTCCACCG
CTGCTCCACCG -> TGCTCCACCGG
TGCTCCACCGG -> GCTCCACCGGC
GCTCCACCGGC -> CTCCACCGGCT
CTCCACCGGCT -> TCCACCGGCTC
TCCACCGGCTC -> CCACCGGCTCC
CCACCGGCTCC -> CACCGGCTCCC
CACCGGCTCCC -> ACCGGCTCCCA
ACCGGCTCCCA -> CCGGCTCCCAT
CCGGCTCCCAT -> CGGCTCCCATC
CGGCTCCCATC -> GGCTCCCATCC
GGCTCCCATCC -> GCTCCCATCCC
GCTCCCATCCC -> CTCCCATCCCC
CTCCCATCCCC -> TCCCATCCCCA
TCCCATCCCCA -> CCCATCCCCAC
CCCATCCCCAC -> CCATCCCCACT
CCATCCCCACT -> CATCCCCACTG
CATCCCCACTG -> ATCCCCACTGG
ATCCCCACTGG -> TCCCCACTGGT
TCCCCACTGGT -> CCCCACTGGTT
CCCCACTGGTT -> CCCACTGGTTA
CCCACTGGTTA -> CCACTGGTTAC
CCACTGGTTAC -> CACTGGTTACG
CACTGGTTACG -> ACTGGTTACGG
ACTGGTTACGG -> CTGGTTACGGG
CTGGTTACGGG -> TGGTTACGGGG
TGGTTACGGGG -> GGTTACGGGGA
GGTTACGGGGA -> GTTACGGGGAA
GTTACGGGGAA -> TTACGGGGAAA
TTACGGGGAAA -> TACGGGGAAAT
TACGGGGAAAT -> ACGGGGAAATA
ACGGGGAAATA -> CGGGGAAATAT
CGGGGAAATAT -> GGGGAAATATA
GGGGAAATATA -> GGGAAATATAT
GGGAAATATAT -> GGAAATATATG
GGAAATATATG -> GAAATATATGC
GAAATATATGC -> AAATATATGCT
AAATATATGCT -> AATATATGCTC
AATATATGCTC -> ATATATGCTCG
ATATATGCTCG -> TATATGCTCGT
TATATGCTCGT -> ATATGCTCGTC
ATATGCTCGTC -> TATGCTCGTCT
TATGCTCGTCT -> ATGCTCGTCTA
ATGCTCGTCTA -> TGCTCGTCTAC
TGCTCGTCTAC -> GCTCGTCTACA
GCTCGTCTACA -> CTCGTCTACAA
CTCGTCTACAA -> TCGTCTACAAC
TCGTCTACAAC -> CGTCTACAACC
CGTCTACAACC -> GTCTACAACCG
GTCTACAACCG -> TCTACAACCGC
TCTACAACCGC -> CTACAACCGCC
CTACAACCGCC -> TACAACCGCCT
TACAACCGCCT -> ACAACCGCCTA
ACAACCGCCTA -> CAACCGCCTAG
CAACCGCCTAG -> AACCGCCTAGC
AACCGCCTAGC -> ACCGCCTAGCA
ACCGCCTAGCA -> CCGCCTAGCAC
CCGCCTAGCAC -> CGCCTAGCACC
CGCCTAGCACC -> GCCTAGCACCA
GCCTAGCACCA -> CCTAGCACCAA
CCTAGCACCAA -> CTAGCACCAAA
CTAGCACCAAA -> TAGCACCAAAA
TAGCACCAAAA -> AGCACCAAAAG
AGCACCAAAAG -> GCACCAAAAGT
GCACCAAAAGT -> CACCAAAAGTT
CACCAAAAGTT -> ACCAAAAGTTT
ACCAAAAGTTT -> CCAAAAGTTTT
CCAAAAGTTTT -> CAAAAGTTTTG
CAAAAGTTTTG -> AAAAGTTTTGG
AAAAGTTTTGG -> AAAGTTTTGGA
AAAGTTTTGGA -> AAGTTTTGGAT
AAGTTTTGGAT -> AGTTTTGGATA
AGTTTTGGATA -> GTTTTGGATAC
GTTTTGGATAC -> TTTTGGATACT
TTTTGGATACT -> TTTGGATACTA
TTTGGATACTA -> TTGGATACTAT
TTGGATACTAT -> TGGATACTATT
TGGATACTATT -> GGATACTATTG
GGATACTATTG -> GATACTATTGC
GATACTATTGC -> ATACTATTGCG
ATACTATTGCG -> TACTATTGCGA
TACTATTGCGA -> ACTATTGCGAC
ACTATTGCGAC -> CTATTGCGACA
CTATTGCGACA -> TATTGCGACAC
TATTGCGACAC -> ATTGCGACACC
ATTGCGACACC -> TTGCGACACCC
TTGCGACACCC -> TGCGACACCCC
TGCGACACCCC -> GCGACACCCCA
GCGACACCCCA -> CGACACCCCAT
CGACACCCCAT -> GACACCCCATA
GACACCCCATA -> ACACCCCATAC
ACACCCCATAC -> CACCCCATACG
CACCCCATACG -> ACCCCATACGG
ACCCCATACGG -> CCCCATACGGG
CCCCATACGGG -> CCCATACGGGC
CCCATACGGGC -> CCATACGGGCG
CCATACGGGCG -> CATACGGGCGG
CATACGGGCGG -> ATACGGGCGGC
ATACGGGCGGC -> TACGGGCGGCG
TACGGGCGGCG -> ACGGGCGGCGC
ACGGGCGGCGC -> CGGGCGGCGCT
CGGGCGGCGCT -> GGGCGGCGCTA
GGGCGGCGCTA -> GGCGGCGCTAC
GGCGGCGCTAC -> GCGGCGCTACG
GCGGCGCTACG -> CGGCGCTACGG
CGGCGCTACGG -> GGCGCTACGGG
GGCGCTACGGG -> GCGCTACGGGT
GCGCTACGGGT -> CGCTACGGGTC
CGCTACGGGTC -> GCTACGGGTCG
GCTACGGGTCG -> CTACGGGTCGA
CTACGGGTCGA -> TACGGGTCGAC
TACGGGTCGAC -> ACGGGTCGACA
ACGGGTCGACA -> CGGGTCGACAA
CGGGTCGACAA -> GGGTCGACAAG
GGGTCGACAAG -> GGTCGACAAGC
GGTCGACAAGC -> GTCGACAAGCT
GTCGACAAGCT -> TCGACAAGCTA
TCGACAAGCTA -> CGACAAGCTAT
CGACAAGCTAT -> GACAAGCTATT
GACAAGCTATT -> ACAAGCTATTA
ACAAGCTATTA -> CAAGCTATTAG
CAAGCTATTAG -> AAGCTATTAGC
AAGCTATTAGC -> AGCTATTAGCA
AGCTATTAGCA -> GCTATTAGCAA
GCTATTAGCAA -> CTATTAGCAAC
CTATTAGCAAC -> TATTAGCAACG
TATTAGCAACG -> ATTAGCAACGT
ATTAGCAACGT -> TTAGCAACGTA
TTAGCAACGTA -> TAGCAACGTAA
TAGCAACGTAA -> AGCAACGTAAT
AGCAACGTAAT -> GCAACGTAATT
GCAACGTAATT -> CAACGTAATTC
CAACGTAATTC -> AACGTAATTCG
AACGTAATTCG -> ACGTAATTCGG
ACGTAATTCGG -> CGTAATTCGGG
CGTAATTCGGG -> GTAATTCGGGG
GTAATTCGGGG -> TAATTCGGGGC
TAATTCGGGGC -> AATTCGGGGCC
AATTCGGGGCC -> ATTCGGGGCCT
ATTCGGGGCCT -> TTCGGGGCCTA
TTCGGGGCCTA -> TCGGGGCCTAC
TCGGGGCCTAC -> CGGGGCCTACC
CGGGGCCTACC -> GGGGCCTACCT
GGGGCCTACCT -> GGGCCTACCTT
GGGCCTACCTT -> GGCCTACCTTC
GGCCTACCTTC -> GCCTACCTTCT
GCCTACCTTCT -> CCTACCTTCTG
CCTACCTTCTG -> CTACCTTCTGT
CTACCTTCTGT -> TACCTTCTGTA
TACCTTCTGTA -> ACCTTCTGTAG
ACCTTCTGTAG -> CCTTCTGTAGA
CCTTCTGTAGA -> CTTCTGTAGAA
CTTCTGTAGAA -> TTCTGTAGAAG
TTCTGTAGAAG -> TCTGTAGAAGT
TCTGTAGAAGT -> CTGTAGAAGTG
CTGTAGAAGTG -> TGTAGAAGTGT
TGTAGAAGTGT -> GTAGAAGTGTT
GTAGAAGTGTT -> TAGAAGTGTTT
TAGAAGTGTTT -> AGAAGTGTTTT
AGAAGTGTTTT -> GAAGTGTTTTC
GAAGTGTTTTC -> AAGTGTTTTCA
AAGTGTTTTCA -> AGTGTTTTCAT
AGTGTTTTCAT -> GTGTTTTCATT
GTGTTTTCATT -> TGTTTTCATTT
TGTTTTCATTT -> GTTTTCATTTG
GTTTTCATTTG -> TTTTCATTTGT
TTTTCATTTGT -> TTTCATTTGTG
TTTCATTTGTG -> TTCATTTGTGA
TTCATTTGTGA -> TCATTTGTGAC
TCATTTGTGAC -> CATTTGTGACG
CATTTGTGACG -> ATTTGTGACGG
ATTTGTGACGG -> TTTGTGACGGC
TTTGTGACGGC -> TTGTGACGGCA
TTGTGACGGCA -> TGTGACGGCAG
TGTGACGGCAG -> GTGACGGCAGT
GTGACGGCAGT -> TGACGGCAGTA
TGACGGCAGTA -> GACGGCAGTAC
GACGGCAGTAC -> ACGGCAGTACG
ACGGCAGTACG -> CGGCAGTACGG
CGGCAGTACGG -> GGCAGTACGGC
GGCAGTACGGC -> GCAGTACGGCC
GCAGTACGGCC -> CAGTACGGCCG
CAGTACGGCCG -> AGTACGGCCGG
AGTACGGCCGG -> GTACGGCCGGA
GTACGGCCGGA -> TACGGCCGGAT
TACGGCCGGAT -> ACGGCCGGATT
ACGGCCGGATT -> CGGCCGGATTC
CGGCCGGATTC -> GGCCGGATTCG
GGCCGGATTCG -> GCCGGATTCGC
GCCGGATTCGC -> CCGGATTCGCA
CCGGATTCGCA -> CGGATTCGCAT
CGGATTCGCAT -> GGATTCGCATC
GGATTCGCATC -> GATTCGCATCA
GATTCGCATCA -> ATTCGCATCAC
ATTCGCATCAC -> TTCGCATCACC
TTCGCATCACC -> TCGCATCACCC
TCGCATCACCC -> CGCATCACCCG
CGCATCACCCG -> GCATCACCCGC
GCATCACCCGC -> CATCACCCGCA
CATCACCCGCA -> ATCACCCGCAC
ATCACCCGCAC -> TCACCCGCACA
TCACCCGCACA -> CACCCGCACAG
CACCCGCACAG -> ACCCGCACAGG
ACCCGCACAGG -> CCCGCACAGGA
CCCGCACAGGA -> CCGCACAGGAA
CCGCACAGGAA -> CGCACAGGAAT
CGCACAGGAAT -> GCACAGGAATC
GCACAGGAATC -> CACAGGAATCA
CACAGGAATCA -> ACAGGAATCAG
ACAGGAATCAG -> CAGGAATCAGT
CAGGAATCAGT -> AGGAATCAGTG
AGGAATCAGTG -> GGAATCAGTGC
GGAATCAGTGC -> GAATCAGTGCA
GAATCAGTGCA -> AATCAGTGCAC
AATCAGTGCAC -> ATCAGTGCACA
ATCAGTGCACA -> TCAGTGCACAC
TCAGTGCACAC -> CAGTGCACACC
CAGTGCACACC -> AGTGCACACCG
AGTGCACACCG -> GTGCACACCGC
GTGCACACCGC -> TGCACACCGCA
TGCACACCGCA -> GCACACCGCAT
GCACACCGCAT -> CACACCGCATG
CACACCGCATG -> ACACCGCATGG
ACACCGCATGG -> CACCGCATGGT
CACCGCATGGT -> ACCGCATGGTG
ACCGCATGGTG -> CCGCATGGTGG
CCGCATGGTGG -> CGCATGGTGGC
CGCATGGTGGC -> GCATGGTGGCC
GCATGGTGGCC -> CATGGTGGCCC
CATGGTGGCCC -> ATGGTGGCCCA
ATGGTGGCCCA -> TGGTGGCCCAA
TGGTGGCCCAA -> GGTGGCCCAAG
GGTGGCCCAAG -> GTGGCCCAAGA
GTGGCCCAAGA -> TGGCCCAAGAG
TGGCCCAAGAG -> GGCCCAAGAGG
GGCCCAAGAGG -> GCCCAAGAGGA
GCCCAAGAGGA -> CCCAAGAGGAA
CCCAAGAGGAA -> CCAAGAGGAAT
CCAAGAGGAAT -> CAAGAGGAATA
CAAGAGGAATA -> AAGAGGAATAG
AAGAGGAATAG -> AGAGGAATAGA
AGAGGAATAGA -> GAGGAATAGAC
GAGGAATAGAC -> AGGAATAGACC
AGGAATAGACC -> GGAATAGACCA
GGAATAGACCA -> GAATAGACCAC
GAATAGACCAC -> AATAGACCACG
AATAGACCACG -> ATAGACCACGC
ATAGACCACGC -> TAGACCACGCG
TAGACCACGCG -> AGACCACGCGT
AGACCACGCGT -> GACCACGCGTG
GACCACGCGTG -> ACCACGCGTGC
ACCACGCGTGC -> CCACGCGTGCT
CCACGCGTGCT -> CACGCGTGCTG
CACGCGTGCTG -> ACGCGTGCTGC
ACGCGTGCTGC -> CGCGTGCTGCG
CGCGTGCTGCG -> GCGTGCTGCGG
GCGTGCTGCGG -> CGTGCTGCGGG
CGTGCTGCGGG -> GTGCTGCGGGC
GTGCTGCGGGC -> TGCTGCGGGCT
TGCTGCGGGCT -> GCTGCGGGCTG
GCTGCGGGCTG -> CTGCGGGCTGC
CTGCGGGCTGC -> TGCGGGCTGCA
TGCGGGCTGCA -> GCGGGCTGCAG
GCGGGCTGCAG -> CGGGCTGCAGG
CGGGCTGCAGG -> GGGCTGCAGGA
GGGCTGCAGGA -> GGCTGCAGGAG
GGCTGCAGGAG -> GCTGCAGGAGC
GCTGCAGGAGC -> CTGCAGGAGCT
CTGCAGGAGCT -> TGCAGGAGCTT
TGCAGGAGCTT -> GCAGGAGCTTT
GCAGGAGCTTT -> CAGGAGCTTTA
CAGGAGCTTTA -> AGGAGCTTTAT
AGGAGCTTTAT -> GGAGCTTTATC
GGAGCTTTATC -> GAGCTTTATCA
GAGCTTTATCA -> AGCTTTATCAA
AGCTTTATCAA -> GCTTTATCAAA
GCTTTATCAAA -> CTTTATCAAAG
CTTTATCAAAG -> TTTATCAAAGT
TTTATCAAAGT -> TTATCAAAGTC
TTATCAAAGTC -> TATCAAAGTCG
TATCAAAGTCG -> ATCAAAGTCGT
ATCAAAGTCGT -> TCAAAGTCGTA
TCAAAGTCGTA -> CAAAGTCGTAA
CAAAGTCGTAA -> AAAGTCGTAAT
AAAGTCGTAAT -> AAGTCGTAATG
AAGTCGTAATG -> AGTCGTAATGG
AGTCGTAATGG -> GTCGTAATGGT
GTCGTAATGGT -> TCGTAATGGTA
TCGTAATGGTA -> CGTAATGGTAG
CGTAATGGTAG -> GTAATGGTAGC
GTAATGGTAGC -> TAATGGTAGCC
TAATGGTAGCC -> AATGGTAGCCG
AATGGTAGCCG -> ATGGTAGCCGC
ATGGTAGCCGC -> TGGTAGCCGCT
TGGTAGCCGCT -> GGTAGCCGCTA
GGTAGCCGCTA -> GTAGCCGCTAC
GTAGCCGCTAC -> TAGCCGCTACG
TAGCCGCTACG -> AGCCGCTACGC
AGCCGCTACGC -> GCCGCTACGCT
GCCGCTACGCT -> CCGCTACGCTT
CCGCTACGCTT -> CGCTACGCTTA
CGCTACGCTTA -> GCTACGCTTAC
GCTACGCTTAC -> CTACGCTTACA
CTACGCTTACA -> TACGCTTACAG
TACGCTTACAG -> ACGCTTACAGG
ACGCTTACAGG -> CGCTTACAGGT
CGCTTACAGGT -> GCTTACAGGTC
GCTTACAGGTC -> CTTACAGGTCG
CTTACAGGTCG -> TTACAGGTCGA
TTACAGGTCGA -> TACAGGTCGAC
TACAGGTCGAC -> ACAGGTCGACC
ACAGGTCGACC -> CAGGTCGACCG
CAGGTCGACCG -> AGGTCGACCGA
AGGTCGACCGA -> GGTCGACCGAC
GGTCGACCGAC -> GTCGACCGACG
GTCGACCGACG -> TCGACCGACGT
TCGACCGACGT -> CGACCGACGTT
CGACCGACGTT -> GACCGACGTTC
GACCGACGTTC -> ACCGACGTTCT
ACCGACGTTCT -> CCGACGTTCTT
CCGACGTTCTT -> CGACGTTCTTC
CGACGTTCTTC -> GACGTTCTTCG
GACGTTCTTCG -> ACGTTCTTCGA
ACGTTCTTCGA -> CGTTCTTCGAG
CGTTCTTCGAG -> GTTCTTCGAGC
GTTCTTCGAGC -> TTCTTCGAGCG
TTCTTCGAGCG -> TCTTCGAGCGT
TCTTCGAGCGT -> CTTCGAGCGTC
CTTCGAGCGTC -> TTCGAGCGTCA
TTCGAGCGTCA -> TCGAGCGTCAT
TCGAGCGTCAT -> CGAGCGTCATA
CGAGCGTCATA -> GAGCGTCATAT
GAGCGTCATAT -> AGCGTCATATT
AGCGTCATATT -> GCGTCATATTA
GCGTCATATTA -> CGTCATATTAG
CGTCATATTAG -> GTCATATTAGA
GTCATATTAGA -> TCATATTAGAC
TCATATTAGAC -> CATATTAGACG
CATATTAGACG -> ATATTAGACGC
ATATTAGACGC -> TATTAGACGCA
TATTAGACGCA -> ATTAGACGCAC
ATTAGACGCAC -> TTAGACGCACG
TTAGACGCACG -> TAGACGCACGT
TAGACGCACGT -> AGACGCACGTC
AGACGCACGTC -> GACGCACGTCA
GACGCACGTCA -> ACGCACGTCAC
ACGCACGTCAC -> CGCACGTCACA
CGCACGTCACA -> GCACGTCACAA
GCACGTCACAA -> CACGTCACAAG
CACGTCACAAG -> ACGTCACAAGG
ACGTCACAAGG -> CGTCACAAGGC
CGTCACAAGGC -> GTCACAAGGCA
GTCACAAGGCA -> TCACAAGGCAT
TCACAAGGCAT -> CACAAGGCATG
CACAAGGCATG -> ACAAGGCATGG
ACAAGGCATGG -> CAAGGCATGGA
CAAGGCATGGA -> AAGGCATGGAG
AAGGCATGGAG -> AGGCATGGAGC
AGGCATGGAGC -> GGCATGGAGCG
GGCATGGAGCG -> GCATGGAGCGA
GCATGGAGCGA -> CATGGAGCGAA
CATGGAGCGAA -> ATGGAGCGAAT
ATGGAGCGAAT -> TGGAGCGAATA
TGGAGCGAATA -> GGAGCGAATAT
GGAGCGAATAT -> GAGCGAATATA
GAGCGAATATA -> AGCGAATATAA
AGCGAATATAA -> GCGAATATAAC
GCGAATATAAC -> CGAATATAACT
CGAATATAACT -> GAATATAACTA
GAATATAACTA -> AATATAACTAG
AATATAACTAG -> ATATAACTAGC
ATATAACTAGC -> TATAACTAGCG
TATAACTAGCG -> ATAACTAGCGA
ATAACTAGCGA -> TAACTAGCGAT
TAACTAGCGAT -> AACTAGCGATG
AACTAGCGATG -> ACTAGCGATGC
ACTAGCGATGC -> CTAGCGATGCG
CTAGCGATGCG -> TAGCGATGCGT
TAGCGATGCGT -> AGCGATGCGTA
AGCGATGCGTA -> GCGATGCGTAG
GCGATGCGTAG -> CGATGCGTAGT
CGATGCGTAGT -> GATGCGTAGTA
GATGCGTAGTA -> ATGCGTAGTAG
ATGCGTAGTAG -> TGCGTAGTAGG
TGCGTAGTAGG -> GCGTAGTAGGA
GCGTAGTAGGA -> CGTAGTAGGAT
CGTAGTAGGAT -> GTAGTAGGATC
GTAGTAGGATC -> TAGTAGGATCA
TAGTAGGATCA -> AGTAGGATCAT
AGTAGGATCAT -> GTAGGATCATT
GTAGGATCATT -> TAGGATCATTT
TAGGATCATTT -> AGGATCATTTG
AGGATCATTTG -> GGATCATTTGC
GGATCATTTGC -> GATCATTTGCA
GATCATTTGCA -> ATCATTTGCAA
ATCATTTGCAA -> TCATTTGCAAA
TCATTTGCAAA -> CATTTGCAAAC
CATTTGCAAAC -> ATTTGCAAACA
ATTTGCAAACA -> TTTGCAAACAT
TTTGCAAACAT -> TTGCAAACATT
TTGCAAACATT -> TGCAAACATTC
TGCAAACATTC -> GCAAACATTCG
GCAAACATTCG -> CAAACATTCGT
CAAACATTCGT -> AAACATTCGTG
AAACATTCGTG -> AACATTCGTGT
AACATTCGTGT -> ACATTCGTGTG
ACATTCGTGTG -> CATTCGTGTGC
CATTCGTGTGC -> ATTCGTGTGCG
ATTCGTGTGCG -> TTCGTGTGCGC
TTCGTGTGCGC -> TCGTGTGCGCT
TCGTGTGCGCT -> CGTGTGCGCTA
CGTGTGCGCTA -> GTGTGCGCTAA
GTGTGCGCTAA -> TGTGCGCTAAT
TGTGCGCTAAT -> GTGCGCTAATT
GTGCGCTAATT -> TGCGCTAATTG
TGCGCTAATTG -> GCGCTAATTGC
GCGCTAATTGC -> CGCTAATTGCG
CGCTAATTGCG -> GCTAATTGCGC
GCTAATTGCGC -> CTAATTGCGCT
CTAATTGCGCT -> TAATTGCGCTA
TAATTGCGCTA -> AATTGCGCTAA
AATTGCGCTAA -> ATTGCGCTAAC
ATTGCGCTAAC -> TTGCGCTAACA
TTGCGCTAACA -> TGCGCTAACAC
TGCGCTAACAC -> GCGCTAACACG
GCGCTAACACG -> CGCTAACACGG
CGCTAACACGG -> GCTAACACGGT
GCTAACACGGT -> CTAACACGGTT
CTAACACGGTT -> TAACACGGTTT
TAACACGGTTT -> AACACGGTTTT
AACACGGTTTT -> ACACGGTTTTA
ACACGGTTTTA -> CACGGTTTTAT
CACGGTTTTAT -> ACGGTTTTATA
ACGGTTTTATA -> CGGTTTTATAA
CGGTTTTATAA -> GGTTTTATAAG
GGTTTTATAAG -> GTTTTATAAGC
GTTTTATAAGC -> TTTTATAAGCG
TTTTATAAGCG -> TTTATAAGCGG
TTTATAAGCGG -> TTATAAGCGGA
TTATAAGCGGA -> TATAAGCGGAC
TATAAGCGGAC -> ATAAGCGGACT
ATAAGCGGACT -> TAAGCGGACTG
TAAGCGGACTG -> AAGCGGACTGT
AAGCGGACTGT -> AGCGGACTGTG
AGCGGACTGTG -> GCGGACTGTGC
GCGGACTGTGC -> CGGACTGTGCT
CGGACTGTGCT -> GGACTGTGCTA
GGACTGTGCTA -> GACTGTGCTAC
GACTGTGCTAC -> ACTGTGCTACT
ACTGTGCTACT -> CTGTGCTACTG
CTGTGCTACTG -> TGTGCTACTGT
TGTGCTACTGT -> GTGCTACTGTA
GTGCTACTGTA -> TGCTACTGTAC
TGCTACTGTAC -> GCTACTGTACC
GCTACTGTACC -> CTACTGTACCT
CTACTGTACCT -> TACTGTACCTG
TACTGTACCTG -> ACTGTACCTGG
ACTGTACCTGG -> CTGTACCTGGA
CTGTACCTGGA -> TGTACCTGGAT
TGTACCTGGAT -> GTACCTGGATA
GTACCTGGATA -> TACCTGGATAA
TACCTGGATAA -> ACCTGGATAAT
ACCTGGATAAT -> CCTGGATAATA
CCTGGATAATA -> CTGGATAATAG
CTGGATAATAG -> TGGATAATAGC
TGGATAATAGC -> GGATAATAGCT
GGATAATAGCT -> GATAATAGCTT
GATAATAGCTT -> ATAATAGCTTC
ATAATAGCTTC -> TAATAGCTTCC
TAATAGCTTCC -> AATAGCTTCCT
AATAGCTTCCT -> ATAGCTTCCTG
ATAGCTTCCTG -> TAGCTTCCTGT
TAGCTTCCTGT -> AGCTTCCTGTC
AGCTTCCTGTC -> GCTTCCTGTCG
GCTTCCTGTCG -> CTTCCTGTCGC
CTTCCTGTCGC -> TTCCTGTCGCC
TTCCTGTCGCC -> TCCTGTCGCCG
TCCTGTCGCCG -> CCTGTCGCCGG
CCTGTCGCCGG -> CTGTCGCCGGT
CTGTCGCCGGT -> TGTCGCCGGTT
TGTCGCCGGTT -> GTCGCCGGTTC
GTCGCCGGTTC -> TCGCCGGTTCC
TCGCCGGTTCC -> CGCCGGTTCCA
CGCCGGTTCCA -> GCCGGTTCCAT
GCCGGTTCCAT -> CCGGTTCCATC
CCGGTTCCATC -> CGGTTCCATCT
CGGTTCCATCT -> GGTTCCATCTG
GGTTCCATCTG -> GTTCCATCTGA
GTTCCATCTGA -> TTCCATCTGAC
TTCCATCTGAC -> TCCATCTGACA
TCCATCTGACA -> CCATCTGACAA
CCATCTGACAA -> CATCTGACAAA
CATCTGACAAA -> ATCTGACAAAG
ATCTGACAAAG -> TCTGACAAAGC
TCTGACAAAGC -> CTGACAAAGCT
CTGACAAAGCT -> TGACAAAGCTG
TGACAAAGCTG -> GACAAAGCTGC
GACAAAGCTGC -> ACAAAGCTGCC
ACAAAGCTGCC -> CAAAGCTGCCG
CAAAGCTGCCG -> AAAGCTGCCGC
AAAGCTGCCGC -> AAGCTGCCGCC
AAGCTGCCGCC -> AGCTGCCGCCC
AGCTGCCGCCC -> GCTGCCGCCCA
GCTGCCGCCCA -> CTGCCGCCCAG
CTGCCGCCCAG -> TGCCGCCCAGG
TGCCGCCCAGG -> GCCGCCCAGGT
GCCGCCCAGGT -> CCGCCCAGGTA
CCGCCCAGGTA -> CGCCCAGGTAG
CGCCCAGGTAG -> GCCCAGGTAGA
GCCCAGGTAGA -> CCCAGGTAGAC
CCCAGGTAGAC -> CCAGGTAGACA
CCAGGTAGACA -> CAGGTAGACAG
CAGGTAGACAG -> AGGTAGACAGG
AGGTAGACAGG -> GGTAGACAGGG
GGTAGACAGGG -> GTAGACAGGGC
GTAGACAGGGC -> TAGACAGGGCC
TAGACAGGGCC -> AGACAGGGCCC
AGACAGGGCCC -> GACAGGGCCCC
GACAGGGCCCC -> ACAGGGCCCCA
ACAGGGCCCCA -> CAGGGCCCCAA
CAGGGCCCCAA -> AGGGCCCCAAA
AGGGCCCCAAA -> GGGCCCCAAAC
GGGCCCCAAAC -> GGCCCCAAACC
GGCCCCAAACC -> GCCCCAAACCC
GCCCCAAACCC -> CCCCAAACCCG
CCCCAAACCCG -> CCCAAACCCGT
CCCAAACCCGT -> CCAAACCCGTT
CCAAACCCGTT -> CAAACCCGTTG
CAAACCCGTTG -> AAACCCGTTGG
AAACCCGTTGG -> AACCCGTTGGA
AACCCGTTGGA -> ACCCGTTGGAG
ACCCGTTGGAG -> CCCGTTGGAGA
CCCGTTGGAGA -> CCGTTGGAGAA
CCGTTGGAGAA -> CGTTGGAGAAC
CGTTGGAGAAC -> GTTGGAGAACC
GTTGGAGAACC -> TTGGAGAACCA
TTGGAGAACCA -> TGGAGAACCAT
TGGAGAACCAT -> GGAGAACCATT
GGAGAACCATT -> GAGAACCATTC
GAGAACCATTC -> AGAACCATTCA
AGAACCATTCA -> GAACCATTCAA
GAACCATTCAA -> AACCATTCAAG
AACCATTCAAG -> ACCATTCAAGT
ACCATTCAAGT -> CCATTCAAGTC
CCATTCAAGTC -> CATTCAAGTCC
CATTCAAGTCC -> ATTCAAGTCCC
ATTCAAGTCCC -> TTCAAGTCCCG
TTCAAGTCCCG -> TCAAGTCCCGA
TCAAGTCCCGA -> CAAGTCCCGAG
CAAGTCCCGAG -> AAGTCCCGAGC
AAGTCCCGAGC -> AGTCCCGAGCA
AGTCCCGAGCA -> GTCCCGAGCAA
GTCCCGAGCAA -> TCCCGAGCAAC
TCCCGAGCAAC -> CCCGAGCAACG
CCCGAGCAACG -> CCGAGCAACGC
CCGAGCAACGC -> CGAGCAACGCG
CGAGCAACGCG -> GAGCAACGCGG
GAGCAACGCGG -> AGCAACGCGGA
AGCAACGCGGA -> GCAACGCGGAA
GCAACGCGGAA -> CAACGCGGAAT
CAACGCGGAAT -> AACGCGGAATG
AACGCGGAATG -> ACGCGGAATGA
ACGCGGAATGA -> CGCGGAATGAC
CGCGGAATGAC -> GCGGAATGACC
GCGGAATGACC -> CGGAATGACCC
CGGAATGACCC -> GGAATGACCCC
GGAATGACCCC -> GAATGACCCCG
GAATGACCCCG -> AATGACCCCGC
AATGACCCCGC -> ATGACCCCGCG
ATGACCCCGCG -> TGACCCCGCGG
TGACCCCGCGG -> GACCCCGCGGG
GACCCCGCGGG -> ACCCCGCGGGC
ACCCCGCGGGC -> CCCCGCGGGCC
CCCCGCGGGCC -> CCCGCGGGCCA
CCCGCGGGCCA -> CCGCGGGCCAG
CCGCGGGCCAG -> CGCGGGCCAGA
CGCGGGCCAGA -> GCGGGCCAGAG
GCGGGCCAGAG -> CGGGCCAGAGT
CGGGCCAGAGT -> GGGCCAGAGTA
GGGCCAGAGTA -> GGCCAGAGTAT
GGCCAGAGTAT -> GCCAGAGTATA
GCCAGAGTATA -> CCAGAGTATAA
CCAGAGTATAA -> CAGAGTATAAA
CAGAGTATAAA -> AGAGTATAAAC
AGAGTATAAAC -> GAGTATAAACA
GAGTATAAACA -> AGTATAAACAT
AGTATAAACAT -> GTATAAACATC
GTATAAACATC -> TATAAACATCT
TATAAACATCT -> ATAAACATCTT
ATAAACATCTT -> TAAACATCTTA
TAAACATCTTA -> AAACATCTTAG
AAACATCTTAG -> AACATCTTAGC
AACATCTTAGC -> ACATCTTAGCT
ACATCTTAGCT -> CATCTTAGCTG
CATCTTAGCTG -> ATCTTAGCTGA
ATCTTAGCTGA -> TCTTAGCTGAA
TCTTAGCTGAA -> CTTAGCTGAAT
CTTAGCTGAAT -> TTAGCTGAATG
TTAGCTGAATG -> TAGCTGAATGA
TAGCTGAATGA -> AGCTGAATGAT
AGCTGAATGAT -> GCTGAATGATA
GCTGAATGATA -> CTGAATGATAA
CTGAATGATAA -> TGAATGATAAT
TGAATGATAAT -> GAATGATAATA
GAATGATAATA -> AATGATAATAA
AATGATAATAA -> ATGATAATAAC
ATGATAATAAC -> TGATAATAACC
TGATAATAACC -> GATAATAACCT
GATAATAACCT -> ATAATAACCTA
ATAATAACCTA -> TAATAACCTAC
TAATAACCTAC -> AATAACCTACA
AATAACCTACA -> ATAACCTACAT
ATAACCTACAT -> TAACCTACATT
TAACCTACATT -> AACCTACATTG
AACCTACATTG -> ACCTACATTGG
ACCTACATTGG -> CCTACATTGGC
CCTACATTGGC -> CTACATTGGCC
CTACATTGGCC -> TACATTGGCCG,TACATTGGCCA
TACATTGGCCG -> ACATTGGCCGT
ACATTGGCCGT -> CATTGGCCGTG
CATTGGCCGTG -> ATTGGCCGTGT
ATTGGCCGTGT -> TTGGCCGTGTA
TTGGCCGTGTA -> TGGCCGTGTAT
TGGCCGTGTAT -> GGCCGTGTATT
GGCCGTGTATT -> GCCGTGTATTC
GCCGTGTATTC -> CCGTGTATTCT
CCGTGTATTCT -> CGTGTATTCTG
CGTGTATTCTG -> GTGTATTCTGA
GTGTATTCTGA -> TGTATTCTGAG
TGTATTCTGAG -> GTATTCTGAGT
GTATTCTGAGT -> TATTCTGAGTA
TATTCTGAGTA -> ATTCTGAGTAT
ATTCTGAGTAT -> TTCTGAGTATA
TTCTGAGTATA -> TCTGAGTATAC
TCTGAGTATAC -> CTGAGTATACT
CTGAGTATACT -> TGAGTATACTA
TGAGTATACTA -> GAGTATACTAC
GAGTATACTAC -> AGTATACTACT
AGTATACTACT -> GTATACTACTA
GTATACTACTA -> TATACTACTAC
TATACTACTAC -> ATACTACTACC
ATACTACTACC -> TACTACTACCG
TACTACTACCG -> ACTACTACCGG
ACTACTACCGG -> CTACTACCGGA
CTACTACCGGA -> TACTACCGGAC
TACTACCGGAC -> ACTACCGGACA
ACTACCGGACA -> CTACCGGACAA
CTACCGGACAA -> TACCGGACAAT
TACCGGACAAT -> ACCGGACAATC
ACCGGACAATC -> CCGGACAATCT
CCGGACAATCT -> CGGACAATCTG
CGGACAATCTG -> GGACAATCTGC
GGACAATCTGC -> GACAATCTGCG
GACAATCTGCG -> ACAATCTGCGA
ACAATCTGCGA -> CAATCTGCGAC
CAATCTGCGAC -> AATCTGCGACG
AATCTGCGACG -> ATCTGCGACGA
ATCTGCGACGA -> TCTGCGACGAC
TCTGCGACGAC -> CTGCGACGACT
CTGCGACGACT -> TGCGACGACTT
TGCGACGACTT -> GCGACGACTTA
GCGACGACTTA -> CGACGACTTAG
CGACGACTTAG -> GACGACTTAGA
GACGACTTAGA -> ACGACTTAGAC
ACGACTTAGAC -> CGACTTAGACA
CGACTTAGACA -> GACTTAGACAC
GACTTAGACAC -> ACTTAGACACA
ACTTAGACACA -> CTTAGACACAA
CTTAGACACAA -> TTAGACACAAT
TTAGACACAAT -> TAGACACAATC
TAGACACAATC -> AGACACAATCT
AGACACAATCT -> GACACAATCTA
GACACAATCTA -> ACACAATCTAC
ACACAATCTAC -> CACAATCTACG
CACAATCTACG -> ACAATCTACGG
ACAATCTACGG -> CAATCTACGGT
CAATCTACGGT -> AATCTACGGTA
AATCTACGGTA -> ATCTACGGTAG
ATCTACGGTAG -> TCTACGGTAGC
TCTACGGTAGC -> CTACGGTAGCT
CTACGGTAGCT -> TACGGTAGCTC
TACGGTAGCTC -> ACGGTAGCTCG
ACGGTAGCTCG -> CGGTAGCTCGG
CGGTAGCTCGG -> GGTAGCTCGGG
GGTAGCTCGGG -> GTAGCTCGGGC
GTAGCTCGGGC -> TAGCTCGGGCA
TAGCTCGGGCA -> AGCTCGGGCAC
AGCTCGGGCAC -> GCTCGGGCACG
GCTCGGGCACG -> CTCGGGCACGG
CTCGGGCACGG -> TCGGGCACGGT
TCGGGCACGGT -> CGGGCACGGTG
CGGGCACGGTG -> GGGCACGGTGC
GGGCACGGTGC -> GGCACGGTGCG
GGCACGGTGCG -> GCACGGTGCGC
GCACGGTGCGC -> CACGGTGCGCC
CACGGTGCGCC -> ACGGTGCGCCT
ACGGTGCGCCT -> CGGTGCGCCTA
CGGTGCGCCTA -> GGTGCGCCTAT
GGTGCGCCTAT -> GTGCGCCTATT
GTGCGCCTATT -> TGCGCCTATTA
TGCGCCTATTA -> GCGCCTATTAC
GCGCCTATTAC -> CGCCTATTACA
CGCCTATTACA -> GCCTATTACAC
GCCTATTACAC -> CCTATTACACC
CCTATTACACC -> CTATTACACCA
CTATTACACCA -> TATTACACCAG
TATTACACCAG -> ATTACACCAGC
ATTACACCAGC -> TTACACCAGCA
TTACACCAGCA -> TACACCAGCAA
TACACCAGCAA -> ACACCAGCAAT
ACACCAGCAAT -> CACCAGCAATT
CACCAGCAATT -> ACCAGCAATTT
ACCAGCAATTT -> CCAGCAATTTA
CCAGCAATTTA -> CAGCAATTTAA
CAGCAATTTAA -> AGCAATTTAAC
AGCAATTTAAC -> GCAATTTAACA
GCAATTTAACA -> CAATTTAACAA
CAATTTAACAA -> AATTTAACAAC
AATTTAACAAC -> ATTTAACAACA
ATTTAACAACA -> TTTAACAACAT
TTTAACAACAT -> TTAACAACATA
TTAACAACATA -> TAACAACATAG
TAACAACATAG -> AACAACATAGT
AACAACATAGT -> ACAACATAGTA
ACAACATAGTA -> CAACATAGTAG
CAACATAGTAG -> AACATAGTAGT
AACATAGTAGT -> ACATAGTAGTC
ACATAGTAGTC -> CATAGTAGTCG
CATAGTAGTCG -> ATAGTAGTCGT
ATAGTAGTCGT -> TAGTAGTCGTT
TAGTAGTCGTT -> AGTAGTCGTTG
AGTAGTCGTTG -> GTAGTCGTTGC
GTAGTCGTTGC -> TAGTCGTTGCC
TAGTCGTTGCC -> AGTCGTTGCCG
AGTCGTTGCCG -> GTCGTTGCCGC
GTCGTTGCCGC -> TCGTTGCCGCA
TCGTTGCCGCA -> CGTTGCCGCAG
CGTTGCCGCAG -> GTTGCCGCAGC
GTTGCCGCAGC -> TTGCCGCAGCA
TTGCCGCAGCA -> TGCCGCAGCAC
TGCCGCAGCAC -> GCCGCAGCACC
GCCGCAGCACC -> CCGCAGCACCC
CCGCAGCACCC -> CGCAGCACCCG
CGCAGCACCCG -> GCAGCACCCGA
GCAGCACCCGA -> CAGCACCCGAA
CAGCACCCGAA -> AGCACCCGAAA
AGCACCCGAAA -> GCACCCGAAAA
GCACCCGAAAA -> CACCCGAAAAG
CACCCGAAAAG -> ACCCGAAAAGA
ACCCGAAAAGA -> CCCGAAAAGAA
CCCGAAAAGAA -> CCGAAAAGAAA
CCGAAAAGAAA -> CGAAAAGAAAT
CGAAAAGAAAT -> GAAAAGAAATC
GAAAAGAAATC -> AAAAGAAATCA
AAAAGAAATCA -> AAAGAAATCAC
AAAGAAATCAC -> AAGAAATCACC
AAGAAATCACC -> AGAAATCACCA
AGAAATCACCA -> GAAATCACCAC
GAAATCACCAC -> AAATCACCACT
AAATCACCACT -> AATCACCACTG
AATCACCACTG -> ATCACCACTGC
ATCACCACTGC -> TCACCACTGCA
TCACCACTGCA -> CACCACTGCAT
CACCACTGCAT -> ACCACTGCATA
ACCACTGCATA -> CCACTGCATAT
CCACTGCATAT -> CACTGCATATA
CACTGCATATA -> ACTGCATATAG
ACTGCATATAG -> CTGCATATAGA
CTGCATATAGA -> TGCATATAGAC
TGCATATAGAC -> GCATATAGACC
GCATATAGACC -> CATATAGACCG
CATATAGACCG -> ATATAGACCGG
ATATAGACCGG -> TATAGACCGGC
TATAGACCGGC -> ATAGACCGGCC
ATAGACCGGCC -> TAGACCGGCCA
TAGACCGGCCA -> AGACCGGCCAA
AGACCGGCCAA -> GACCGGCCAAA
GACCGGCCAAA -> ACCGGCCAAAC
ACCGGCCAAAC -> CCGGCCAAACG
CCGGCCAAACG -> CGGCCAAACGC
CGGCCAAACGC -> GGCCAAACGCT
GGCCAAACGCT -> GCCAAACGCTA
GCCAAACGCTA -> CCAAACGCTAT
CCAAACGCTAT -> CAAACGCTATG
CAAACGCTATG -> AAACGCTATGT
AAACGCTATGT -> AACGCTATGTC
AACGCTATGTC -> ACGCTATGTCT
ACGCTATGTCT -> CGCTATGTCTC
CGCTATGTCTC -> GCTATGTCTCT
GCTATGTCTCT -> CTATGTCTCTA
CTATGTCTCTA -> TATGTCTCTAC
TATGTCTCTAC -> ATGTCTCTACA
ATGTCTCTACA -> TGTCTCTACAT
TGTCTCTACAT -> GTCTCTACATT
GTCTCTACATT -> TCTCTACATTG
TCTCTACATTG -> CTCTACATTGG
CTCTACATTGG -> TCTACATTGGC
TCTACATTGGC -> CTACATTGGCC
TACATTGGCCA -> ACATTGGCCAT
ACATTGGCCAT -> CATTGGCCATC
CATTGGCCATC -> ATTGGCCATCT
ATTGGCCATCT -> TTGGCCATCTG
TTGGCCATCTG -> TGGCCATCTGA
TGGCCATCTGA -> GGCCATCTGAT
GGCCATCTGAT -> GCCATCTGATC
GCCATCTGATC -> CCATCTGATCG
CCATCTGATCG -> CATCTGATCGA
CATCTGATCGA -> ATCTGATCGAG
ATCTGATCGAG -> TCTGATCGAGG
TCTGATCGAGG -> CTGATCGAGGT
CTGATCGAGGT -> TGATCGAGGTC
TGATCGAGGTC -> GATCGAGGTCC
GATCGAGGTCC -> ATCGAGGTCCG
ATCGAGGTCCG -> TCGAGGTCCGA
TCGAGGTCCGA -> CGAGGTCCGAC
CGAGGTCCGAC -> GAGGTCCGACC
GAGGTCCGACC -> AGGTCCGACCC
AGGTCCGACCC -> GGTCCGACCCG
GGTCCGACCCG -> GTCCGACCCGC
GTCCGACCCGC -> TCCGACCCGCT
TCCGACCCGCT -> CCGACCCGCTT
CCGACCCGCTT -> CGACCCGCTTG
CGACCCGCTTG -> GACCCGCTTGC
GACCCGCTTGC -> ACCCGCTTGCG
ACCCGCTTGCG -> CCCGCTTGCGA
CCCGCTTGCGA -> CCGCTTGCGAG
CCGCTTGCGAG -> CGCTTGCGAGT
CGCTTGCGAGT -> GCTTGCGAGTG
GCTTGCGAGTG -> CTTGCGAGTGA
CTTGCGAGTGA -> TTGCGAGTGAC
TTGCGAGTGAC -> TGCGAGTGACT
TGCGAGTGACT -> GCGAGTGACTT
GCGAGTGACTT -> CGAGTGACTTC
CGAGTGACTTC -> GAGTGACTTCC
GAGTGACTTCC -> AGTGACTTCCA
AGTGACTTCCA -> GTGACTTCCAA
GTGACTTCCAA -> TGACTTCCAAG
TGACTTCCAAG -> GACTTCCAAGA
GACTTCCAAGA -> ACTTCCAAGAT
ACTTCCAAGAT -> CTTCCAAGATA
CTTCCAAGATA -> TTCCAAGATAG
TTCCAAGATAG -> TCCAAGATAGG
TCCAAGATAGG -> CCAAGATAGGG
CCAAGATAGGG -> CAAGATAGGGT
CAAGATAGGGT -> AAGATAGGGTG
AAGATAGGGTG -> AGATAGGGTGT
AGATAGGGTGT -> GATAGGGTGTC
GATAGGGTGTC -> ATAGGGTGTCG
ATAGGGTGTCG -> TAGGGTGTCGT
TAGGGTGTCGT -> AGGGTGTCGTG
AGGGTGTCGTG -> GGGTGTCGTGA
GGGTGTCGTGA -> GGTGTCGTGAG
GGTGTCGTGAG -> GTGTCGTGAGT
GTGTCGTGAGT -> TGTCGTGAGTA
TGTCGTGAGTA -> GTCGTGAGTAA
GTCGTGAGTAA -> TCGTGAGTAAT
TCGTGAGTAAT -> CGTGAGTAATT
CGTGAGTAATT -> GTGAGTAATTT
GTGAGTAATTT -> TGAGTAATTTG
TGAGTAATTTG -> GAGTAATTTGG
GAGTAATTTGG -> AGTAATTTGGA
AGTAATTTGGA -> GTAATTTGGAA
GTAATTTGGAA -> TAATTTGGAAG
TAATTTGGAAG -> AATTTGGAAGG
AATTTGGAAGG -> ATTTGGAAGGA
ATTTGGAAGGA -> TTTGGAAGGAT
TTTGGAAGGAT -> TTGGAAGGATC
TTGGAAGGATC -> TGGAAGGATCT
TGGAAGGATCT -> GGAAGGATCTG
GGAAGGATCTG -> GAAGGATCTGG
GAAGGATCTGG -> AAGGATCTGGA
AAGGATCTGGA -> AGGATCTGGAA
AGGATCTGGAA -> GGATCTGGAAA
GGATCTGGAAA -> GATCTGGAAAT
GATCTGGAAAT -> ATCTGGAAATC
ATCTGGAAATC -> TCTGGAAATCT
TCTGGAAATCT -> CTGGAAATCTT
CTGGAAATCTT -> TGGAAATCTTA
TGGAAATCTTA -> GGAAATCTTAC
GGAAATCTTAC -> GAAATCTTACG
GAAATCTTACG -> AAATCTTACGC
AAATCTTACGC -> AATCTTACGCT
AATCTTACGCT -> ATCTTACGCTT
ATCTTACGCTT -> TCTTACGCTTC
TCTTACGCTTC -> CTTACGCTTCA
CTTACGCTTCA -> TTACGCTTCAG
TTACGCTTCAG -> TACGCTTCAGC
TACGCTTCAGC -> ACGCTTCAGCC
ACGCTTCAGCC -> CGCTTCAGCCC
CGCTTCAGCCC -> GCTTCAGCCCC
GCTTCAGCCCC -> CTTCAGCCCCT
CTTCAGCCCCT -> TTCAGCCCCTT
TTCAGCCCCTT -> TCAGCCCCTTC
TCAGCCCCTTC -> CAGCCCCTTCT
CAGCCCCTTCT -> AGCCCCTTCTT
AGCCCCTTCTT -> GCCCCTTCTTA
GCCCCTTCTTA -> CCCCTTCTTAT
CCCCTTCTTAT -> CCCTTCTTATC
CCCTTCTTATC -> CCTTCTTATCA
CCTTCTTATCA -> CTTCTTATCAG
CTTCTTATCAG -> TTCTTATCAGG
TTCTTATCAGG -> TCTTATCAGGA
TCTTATCAGGA -> CTTATCAGGAG
CTTATCAGGAG -> TTATCAGGAGT
TTATCAGGAGT -> TATCAGGAGTG
TATCAGGAGTG -> ATCAGGAGTGA
ATCAGGAGTGA -> TCAGGAGTGAT
TCAGGAGTGAT -> CAGGAGTGATA
CAGGAGTGATA -> AGGAGTGATAA
AGGAGTGATAA -> GGAGTGATAAA
GGAGTGATAAA -> GAGTGATAAAA
GAGTGATAAAA -> AGTGATAAAAA
AGTGATAAAAA -> GTGATAAAAAC
GTGATAAAAAC -> TGATAAAAACC
TGATAAAAACC -> GATAAAAACCA
GATAAAAACCA -> ATAAAAACCAT
ATAAAAACCAT -> TAAAAACCATT
TAAAAACCATT -> AAAAACCATTG
AAAAACCATTG -> AAAACCATTGG
AAAACCATTGG -> AAACCATTGGT
AAACCATTGGT -> AACCATTGGTG
AACCATTGGTG -> ACCATTGGTGC
ACCATTGGTGC -> CCATTGGTGCG
CCATTGGTGCG -> CATTGGTGCGA
CATTGGTGCGA -> ATTGGTGCGAG
ATTGGTGCGAG -> TTGGTGCGAGT
TTGGTGCGAGT -> TGGTGCGAGTC
TGGTGCGAGTC -> GGTGCGAGTCG
GGTGCGAGTCG -> GTGCGAGTCGA
GTGCGAGTCGA -> TGCGAGTCGAC
TGCGAGTCGAC -> GCGAGTCGACA
GCGAGTCGACA -> CGAGTCGACAT
CGAGTCGACAT -> GAGTCGACATA
GAGTCGACATA -> AGTCGACATAG
AGTCGACATAG -> GTCGACATAGG
GTCGACATAGG -> TCGACATAGGA
TCGACATAGGA -> CGACATAGGAG
CGACATAGGAG -> GACATAGGAGG
GACATAGGAGG -> ACATAGGAGGG
ACATAGGAGGG -> CATAGGAGGGC
CATAGGAGGGC -> ATAGGAGGGCC
ATAGGAGGGCC -> TAGGAGGGCCG
TAGGAGGGCCG -> AGGAGGGCCGC
AGGAGGGCCGC -> GGAGGGCCGCA
GGAGGGCCGCA -> GAGGGCCGCAT
GAGGGCCGCAT -> AGGGCCGCATA
AGGGCCGCATA -> GGGCCGCATAT
GGGCCGCATAT -> GGCCGCATATC
GGCCGCATATC -> GCCGCATATCG
GCCGCATATCG -> CCGCATATCGG
CCGCATATCGG -> CGCATATCGGG
CGCATATCGGG -> GCATATCGGGA
GCATATCGGGA -> CATATCGGGAA
CATATCGGGAA -> ATATCGGGAAT
ATATCGGGAAT -> TATCGGGAATT
TATCGGGAATT -> ATCGGGAATTC
ATCGGGAATTC -> TCGGGAATTCG
TCGGGAATTCG -> CGGGAATTCGA
CGGGAATTCGA -> GGGAATTCGAT
GGGAATTCGAT -> GGAATTCGATC
GGAATTCGATC -> GAATTCGATCA
GAATTCGATCA -> AATTCGATCAA
AATTCGATCAA -> ATTCGATCAAG
ATTCGATCAAG -> TTCGATCAAGC
TTCGATCAAGC -> TCGATCAAGCA
TCGATCAAGCA -> CGATCAAGCAA
CGATCAAGCAA -> GATCAAGCAAC
GATCAAGCAAC -> ATCAAGCAACG
ATCAAGCAACG -> TCAAGCAACGA
TCAAGCAACGA -> CAAGCAACGAG
CAAGCAACGAG -> AAGCAACGAGC
AAGCAACGAGC -> AGCAACGAGCT
AGCAACGAGCT -> GCAACGAGCTG
GCAACGAGCTG -> CAACGAGCTGC
CAACGAGCTGC -> AACGAGCTGCG
AACGAGCTGCG -> ACGAGCTGCGC
ACGAGCTGCGC -> CGAGCTGCGCT
CGAGCTGCGCT -> GAGCTGCGCTC
GAGCTGCGCTC -> AGCTGCGCTCT
AGCTGCGCTCT -> GCTGCGCTCTT
GCTGCGCTCTT -> CTGCGCTCTTG
CTGCGCTCTTG -> TGCGCTCTTGT
TGCGCTCTTGT -> GCGCTCTTGTC
GCGCTCTTGTC -> CGCTCTTGTCG
CGCTCTTGTCG -> GCTCTTGTCGC
GCTCTTGTCGC -> CTCTTGTCGCT
CTCTTGTCGCT -> TCTTGTCGCTT
TCTTGTCGCTT -> CTTGTCGCTTT
CTTGTCGCTTT -> TTGTCGCTTTC
TTGTCGCTTTC -> TGTCGCTTTCA
TGTCGCTTTCA -> GTCGCTTTCAT
GTCGCTTTCAT -> TCGCTTTCATT
TCGCTTTCATT -> CGCTTTCATTG
CGCTTTCATTG -> GCTTTCATTGC
GCTTTCATTGC -> CTTTCATTGCG
CTTTCATTGCG -> TTTCATTGCGC
TTTCATTGCGC -> TTCATTGCGCA
TTCATTGCGCA -> TCATTGCGCAG
TCATTGCGCAG -> CATTGCGCAGT
CATTGCGCAGT -> ATTGCGCAGTT
ATTGCGCAGTT -> TTGCGCAGTTA
TTGCGCAGTTA -> TGCGCAGTTAC
TGCGCAGTTAC -> GCGCAGTTACT
GCGCAGTTACT -> CGCAGTTACTA
CGCAGTTACTA -> GCAGTTACTAT
GCAGTTACTAT -> CAGTTACTATG
CAGTTACTATG -> AGTTACTATGA
AGTTACTATGA -> GTTACTATGAT
GTTACTATGAT -> TTACTATGATC
TTACTATGATC -> TACTATGATCA
TACTATGATCA -> ACTATGATCAT
ACTATGATCAT -> CTATGATCATT
CTATGATCATT -> TATGATCATTT
TATGATCATTT -> ATGATCATTTC
ATGATCATTTC -> TGATCATTTCT
TGATCATTTCT -> GATCATTTCTA
GATCATTTCTA -> ATCATTTCTAG
ATCATTTCTAG -> TCATTTCTAGG
TCATTTCTAGG -> CATTTCTAGGA
CATTTCTAGGA -> ATTTCTAGGAG
ATTTCTAGGAG -> TTTCTAGGAGC
TTTCTAGGAGC -> TTCTAGGAGCT
TTCTAGGAGCT -> TCTAGGAGCTG
TCTAGGAGCTG -> CTAGGAGCTGG
CTAGGAGCTGG -> TAGGAGCTGGC
TAGGAGCTGGC -> AGGAGCTGGCT
AGGAGCTGGCT -> GGAGCTGGCTT
GGAGCTGGCTT -> GAGCTGGCTTC
GAGCTGGCTTC -> AGCTGGCTTCT
AGCTGGCTTCT -> GCTGGCTTCTA
GCTGGCTTCTA -> CTGGCTTCTAG
CTGGCTTCTAG -> TGGCTTCTAGC
TGGCTTCTAGC -> GGCTTCTAGCA
GGCTTCTAGCA -> GCTTCTAGCAC
GCTTCTAGCAC -> CTTCTAGCACT
CTTCTAGCACT -> TTCTAGCACTT
