GGAGCGCGGGTATCAAGGA -> GAGCGCGGGTATCAAGGAG
TATTTAAAGATCGTAGAGG -> ATTTAAAGATCGTAGAGGG
TATAGGAATTTTGTTTGCC -> ATAGGAATTTTGTTTGCCC
AGGAGTACCTAATCTGACC -> GGAGTACCTAATCTGACCA
TGCTGTACTAGGAGTACCT -> GCTGTACTAGGAGTACCTA
ACAACTCCTGACTGCTATC -> CAACTCCTGACTGCTATCG
CGGGCTCCAACTCCGTACG -> GGGCTCCAACTCCGTACGA
GAATCCTGTAACAAACCCT -> AATCCTGTAACAAACCCTC
GGAGCCACTAGTCTGACCT -> GAGCCACTAGTCTGACCTC
ACAAACGGGACGCTACGAA -> CAAACGGGACGCTACGAAG
GAATCAACTTCAGGGACTT -> AATCAACTTCAGGGACTTT
GAAGCACTGACGACGTAGT -> AAGCACTGACGACGTAGTT
TACATTTAAACAATAAGGG -> ACATTTAAACAATAAGGGC
ATCGGCTTAAGTAATATAA -> TCGGCTTAAGTAATATAAG
TTTTTTGTACGGAACCTCG -> TTTTTGTACGGAACCTCGG
ACCTAATGCAGCCGCCGAC -> CCTAATGCAGCCGCCGACC
AGCCACAAACAAACGGGAC -> GCCACAAACAAACGGGACG
CGGGCCTCCCAATGACTAT -> GGGCCTCCCAATGACTATG
GCCGCAGAGCCCGTTTGCC -> CCGCAGAGCCCGTTTGCCT
GGTGGAGCGCGGGTATCAA -> GTGGAGCGCGGGTATCAAG
GCATCTGCCCAGTGCAACA -> CATCTGCCCAGTGCAACAA
ATCCGTCGGGAGTACATTT -> TCCGTCGGGAGTACATTTA
CCTAATCTGACCAATCTAA -> CTAATCTGACCAATCTAAT
TTAGCCCGGCTCGCGTGTG -> TAGCCCGGCTCGCGTGTGC
ATTCGATTGCGCAGAGGGC -> TTCGATTGCGCAGAGGGCG
AGCCACTAGTCTGACCTCT -> GCCACTAGTCTGACCTCTT
CTTAGCGATGAATCCTGTA -> TTAGCGATGAATCCTGTAA
GTACCAGTTGTTTATGTTT -> TACCAGTTGTTTATGTTTT
GATTTAATAGCAAGGGATC -> ATTTAATAGCAAGGGATCG
CATGCATCTTTTAAGGCGC -> ATGCATCTTTTAAGGCGCC
CATAGAAATGTTAAGGTCA -> ATAGAAATGTTAAGGTCAG
AAGTAATATAAGTGCCCAT -> AGTAATATAAGTGCCCATT
GCTTAAGTAATATAAGTGC -> CTTAAGTAATATAAGTGCC
ACCTGTAATTATGACCTAA -> CCTGTAATTATGACCTAAT
GACGAGTTGGCATGCGCCG -> ACGAGTTGGCATGCGCCGA
AGCCAGCGAACGAAACCAC -> GCCAGCGAACGAAACCACG
GTAATGGAGTTATATTATG -> TAATGGAGTTATATTATGG
AACTGACTACACATTTCTG -> ACTGACTACACATTTCTGA
ACCAGATGGGATGCGTCAC -> CCAGATGGGATGCGTCACT
GAGTTATATTATGGAATTA -> AGTTATATTATGGAATTAG
AGGGTAGTATAGCCCTGGC -> GGGTAGTATAGCCCTGGCG
ACCGAACAGATTTCCTTTA -> CCGAACAGATTTCCTTTAG
AAGGTCAGTCTTGAGATGA -> AGGTCAGTCTTGAGATGAT
GACACTCCTATTGTCTCCA -> ACACTCCTATTGTCTCCAC
TTTAATAGCAAGGGATCGT -> TTAATAGCAAGGGATCGTA
ACCGCGAGCGGGTGGAGCG -> CCGCGAGCGGGTGGAGCGC
GATTGCGCAGAGGGCGCCC -> ATTGCGCAGAGGGCGCCCC
AAGTGCCCATTTGTATTTA -> AGTGCCCATTTGTATTTAA
ACGTAACCTTGGTAAGTGT -> CGTAACCTTGGTAAGTGTA
CTGTACTAGGAGTACCTAA -> TGTACTAGGAGTACCTAAT
GCGTGTGCACCTGTAATTA -> CGTGTGCACCTGTAATTAT
GCGCTTTGAACATGGCCTT -> CGCTTTGAACATGGCCTTC
TACCGGAACCTTACAGTTA -> ACCGGAACCTTACAGTTAT
GGGCCTCCCAATGACTATG -> GGCCTCCCAATGACTATGG
TTTGTATTTAAAGATCGTA -> TTGTATTTAAAGATCGTAG
GACCACCTAATTCTGGGCT -> ACCACCTAATTCTGGGCTA
GTGACGGCTGCAATTCAAG -> TGACGGCTGCAATTCAAGG
CGTTGAGTTCCATTCCACT -> GTTGAGTTCCATTCCACTT
TATATTATGGAATTAGGAC -> ATATTATGGAATTAGGACA
AACTCCTGACTGCTATCGG -> ACTCCTGACTGCTATCGGA
GGTGCTAGTTATGACTAAT -> GTGCTAGTTATGACTAATT
GAATTTTGTTTGCCCCACG -> AATTTTGTTTGCCCCACGT
TAGCCCTGGCGGACCCCCA -> AGCCCTGGCGGACCCCCAA
TTGTGATAGCTAATAACGG -> TGTGATAGCTAATAACGGT
AGGGATCGTAGACCACCTA -> GGGATCGTAGACCACCTAA
CGCCGACCACCGTGGCTGC -> GCCGACCACCGTGGCTGCA
TGCACCCGATAGAGCCACA -> GCACCCGATAGAGCCACAA
AGCCGCAGAGCCCGTTTGC -> GCCGCAGAGCCCGTTTGCC
CTAAGGTCATAGCCGTTGC -> TAAGGTCATAGCCGTTGCT
AACAGATTTCCTTTAGCTG -> ACAGATTTCCTTTAGCTGA
CACCGGCAGGGTACCTCTC -> ACCGGCAGGGTACCTCTCG
AATACCGGAACCTTACAGT -> ATACCGGAACCTTACAGTT
CTACGGATTGGAGAACCAG -> TACGGATTGGAGAACCAGG
CAATTCAAGGAGCCACTAG -> AATTCAAGGAGCCACTAGT
GGTGCAACGTATCATTCAA -> GTGCAACGTATCATTCAAG
CCGCCGCATCTGCCCAGTG -> CGCCGCATCTGCCCAGTGC
ACCTCTCGTCTGGTGACTT -> CCTCTCGTCTGGTGACTTA
TATATCCGTCGGGAGTACA -> ATATCCGTCGGGAGTACAT
TAATGTAGACGCAGGACGT -> AATGTAGACGCAGGACGTA
TCGTTGTCCTCAACTCCGT -> CGTTGTCCTCAACTCCGTG
GGTAGTATAGCCCTGGCGG -> GTAGTATAGCCCTGGCGGA
TTCAGCAGCCAGCGAACGA -> TCAGCAGCCAGCGAACGAA
ATTACGATAGGTAGTACAT -> TTACGATAGGTAGTACATC
CCTTGGACCACTTCCGTAC -> CTTGGACCACTTCCGTACC
TTTCTACCGAACAGATTTC -> TTCTACCGAACAGATTTCC
CAAACGGGACGCTACGAAG -> AAACGGGACGCTACGAAGC
GCTGCAATTCAAGGAGCCA -> CTGCAATTCAAGGAGCCAC
CCCCACGTAACCTTGGTAA -> CCCACGTAACCTTGGTAAG
GCAGCCAGCGAACGAAACC -> CAGCCAGCGAACGAAACCA
TAGTCTGTATTGCTTTGGT -> AGTCTGTATTGCTTTGGTT
ATCTTTTAAGGCGCCTCGA -> TCTTTTAAGGCGCCTCGAT
TGTGTACCATAGATCGGCT -> GTGTACCATAGATCGGCTT
CGGTTGGCACGGTCATGGG -> GGTTGGCACGGTCATGGGA
GGATGCGTCACTTAGCCCA -> GATGCGTCACTTAGCCCAC
CGACCGAACTGACTACACA -> GACCGAACTGACTACACAT
TGACGACGTAGTTTGACGA -> GACGACGTAGTTTGACGAC
GGCTGCACCTGTCGACCAG -> GCTGCACCTGTCGACCAGA
GAGCCACTAGTCTGTATTG -> AGCCACTAGTCTGTATTGC
TTGGAAGCCTTCGAGCTTC -> TGGAAGCCTTCGAGCTTCA
TGTCCTCAACTCCGTGGCG -> GTCCTCAACTCCGTGGCGT
TGCAACGTATCATTCAAGG -> GCAACGTATCATTCAAGGA
GAGCGGGTGTACATTTACC -> AGCGGGTGTACATTTACCA
GTGTACCATAGATCGGCTT -> TGTACCATAGATCGGCTTA
GCAGGGTACCTCTCGTCTG -> CAGGGTACCTCTCGTCTGG
AACTCCGTACGAATCACTG -> ACTCCGTACGAATCACTGC
CCACGTCCATCCACTTGCT -> CACGTCCATCCACTTGCTA
GAACCTCGGTCTCTTTATG -> AACCTCGGTCTCTTTATGT
CCGCGAGCGGGTGTACATT -> CGCGAGCGGGTGTACATTT
CAATTTGGAAGCCTTCGAG -> AATTTGGAAGCCTTCGAGC
TGACGCTGATCACACCACC -> GACGCTGATCACACCACCC
CCGTACCGCGAGCGGGTGG -> CGTACCGCGAGCGGGTGGA
CTCAGTCGAATTCGATTGC -> TCAGTCGAATTCGATTGCG
TTTCCTACCAAGATAGCTC -> TTCCTACCAAGATAGCTCG
CTAATGCTTTCTTGCCCAC -> TAATGCTTTCTTGCCCACG
GTCTCTTTATGTTAGCACT -> TCTCTTTATGTTAGCACTT
TCGAATGCATTACAGAGCT -> CGAATGCATTACAGAGCTC
GTAACCTTGGTAAGTGTAC -> TAACCTTGGTAAGTGTACC
GTTTGCCCCACGTAACCTT -> TTTGCCCCACGTAACCTTG
AGTATAGCCGCTTACCTAA -> GTATAGCCGCTTACCTAAA
CGGAACCTTACAGTTATCC -> GGAACCTTACAGTTATCCG
ATCAAAGTGCGTTCGGGCC -> TCAAAGTGCGTTCGGGCCT
AAATCCACCGCCATTGTGA -> AATCCACCGCCATTGTGAT
CCGTTGCTTTCCCGAGTTT -> CGTTGCTTTCCCGAGTTTT
TCTGACCAATCTAATTAGC -> CTGACCAATCTAATTAGCC
CAGGCGCTTTGAACATGGC -> AGGCGCTTTGAACATGGCC
TGGAGTAATGGAGTTATAT -> GGAGTAATGGAGTTATATT
GCTCGCGTGTGCACCTGTA -> CTCGCGTGTGCACCTGTAA
ACATGGCCTTCAGCAGAAC -> CATGGCCTTCAGCAGAACG
CCTTGTGCGTATCCTAACT -> CTTGTGCGTATCCTAACTT
GGGTATCAAGGAGCCACTA -> GGTATCAAGGAGCCACTAG
GGTCATAGCCGTTGCTTTC -> GTCATAGCCGTTGCTTTCC
GTTTGACGACCGAACTGAC -> TTTGACGACCGAACTGACT
CAGGAATAGTGACGCTGAT -> AGGAATAGTGACGCTGATC
ATCCACCGCCATTGTGATA -> TCCACCGCCATTGTGATAG
CAACTCCTGACTGCTATCG -> AACTCCTGACTGCTATCGG
TTGTTTATGTTTTCCTACC -> TGTTTATGTTTTCCTACCA
GGCGCCTCGATCAAAACTC -> GCGCCTCGATCAAAACTCG
AGTCTGTATTGCTTTGGTT -> GTCTGTATTGCTTTGGTTT
TAGCCGCTTACCTAAACCA -> AGCCGCTTACCTAAACCAG
CCCTCTCCTCCTGTACTGG -> CCTCTCCTCCTGTACTGGG
GAGCGGGTGCAACGTATCA -> AGCGGGTGCAACGTATCAT
TACGCGCAACACGTTGCTG -> ACGCGCAACACGTTGCTGT
GGCCTTCAGCAGCCAGCGA -> GCCTTCAGCAGCCAGCGAA
AACCACGATGGAGTAATGG -> ACCACGATGGAGTAATGGA
CTACACATTTCTGAACTGC -> TACACATTTCTGAACTGCC
ATAGCCGTTGCTTTCCCGA -> TAGCCGTTGCTTTCCCGAG
TGTGGCGAATCGCTGGCGA -> GTGGCGAATCGCTGGCGAC
TTTAAAGATCGTAGAGGGT -> TTAAAGATCGTAGAGGGTA
CGCGATCCGGTCTGGGAGC -> GCGATCCGGTCTGGGAGCG
GTACCGCGAGCGGGTGTAC -> TACCGCGAGCGGGTGTACA
CAACAATAATTCAGAGTGC -> AACAATAATTCAGAGTGCG
ACATTTAAACAATAAGGGC -> CATTTAAACAATAAGGGCC
GAGCTACCTATATCCGCGG -> AGCTACCTATATCCGCGGC
AAGGTCATAGCCGTTGCTT -> AGGTCATAGCCGTTGCTTT
GAGCCACTAGTCTGACCTC -> AGCCACTAGTCTGACCTCT
ACGACGTAGTTTGACGACC -> CGACGTAGTTTGACGACCG
ATAAGTGCCCATTTGTATT -> TAAGTGCCCATTTGTATTT
TAATGCTTTCTTGCCCACG -> AATGCTTTCTTGCCCACGT
AATACTCCCCAAATTAATA -> ATACTCCCCAAATTAATAC
GTATTTAAAGATCGTAGAG -> TATTTAAAGATCGTAGAGG
CGGTCCGTGCATGGAGTAT -> GGTCCGTGCATGGAGTATA
CTTGAGCACGCAGGGTCCT -> TTGAGCACGCAGGGTCCTG
ACTTTAAATTAGCAGTGCA -> CTTTAAATTAGCAGTGCAT
TAGAGGGTAGTATAGCCCT -> AGAGGGTAGTATAGCCCTG
GTAGACGCAGGACGTAGTA -> TAGACGCAGGACGTAGTAG
ACCTAAACCAGAAAACAAT -> CCTAAACCAGAAAACAATA
ACAGGAATAGTGACGCTGA -> CAGGAATAGTGACGCTGAT
GTACCGCGAGCGGGTGGAG -> TACCGCGAGCGGGTGGAGC
TCTGGGCTAAGCCTTGGAC -> CTGGGCTAAGCCTTGGACC
GCCCTGGCGGACCCCCAAC -> CCCTGGCGGACCCCCAACG
TCCTCCTGTACTGGGTAAC -> CCTCCTGTACTGGGTAACC
TTTGTGTACCATAGATCGG -> TTGTGTACCATAGATCGGC
GTGGCGAATCGCTGGCGAC -> TGGCGAATCGCTGGCGACG
TATAGCCCTGGCGGACCCC -> ATAGCCCTGGCGGACCCCC
TCACCCACGAAATCCACCG -> CACCCACGAAATCCACCGC
GTTTATGTTTTCCTACCAA -> TTTATGTTTTCCTACCAAG
GAGCGAAGCACTGACGACG -> AGCGAAGCACTGACGACGT
GCGAGCGGGTGACGGCTGC -> CGAGCGGGTGACGGCTGCA
TTATATCGACTGATGAGGG -> TATATCGACTGATGAGGGT
CTCGATCAAAACTCGCCGA -> TCGATCAAAACTCGCCGAA
ATTTGTATTTAAAGATCGT -> TTTGTATTTAAAGATCGTA
AGCTCACCCACGAAATCCA -> GCTCACCCACGAAATCCAC
GTAGTTTGACGACCGAACT -> TAGTTTGACGACCGAACTG
TTAGCACTTTAAATTAGCA -> TAGCACTTTAAATTAGCAG
CAGATGGGATGCGTCACTT -> AGATGGGATGCGTCACTTA
ACTCAATCTCAGTCGAATT -> CTCAATCTCAGTCGAATTC
AGTAATGGAGTTATATTAT -> GTAATGGAGTTATATTATG
AAACGGGCTCCAACTCCGT -> AACGGGCTCCAACTCCGTA
GAATAGTGACGCTGATCAC -> AATAGTGACGCTGATCACA
GCTGATCACACCACCCACT -> CTGATCACACCACCCACTT
ACTGGGTAACCCATAGAAA -> CTGGGTAACCCATAGAAAT
GAACCAGGCGCTTTGAACA -> AACCAGGCGCTTTGAACAT
GTACATCTCGCTTAGCGAT -> TACATCTCGCTTAGCGATG
CCGTCGTCCGATACCCTCG -> CGTCGTCCGATACCCTCGA
CAAGATAGCTCGTATACTT -> AAGATAGCTCGTATACTTT
TAGGGCTACGAGAGGGCCG -> AGGGCTACGAGAGGGCCGC
TCCTCAACTCCGTGGCGTG -> CCTCAACTCCGTGGCGTGA
CTGATCGAGAGGACATGTC -> TGATCGAGAGGACATGTCC
CATTCGAATGCTGCACCCG -> ATTCGAATGCTGCACCCGA
GTACATTTACCATCAAGGA -> TACATTTACCATCAAGGAG
TTATGTTAGCACTTTAAAT -> TATGTTAGCACTTTAAATT
CATCTCGCTTAGCGATGAA -> ATCTCGCTTAGCGATGAAT
TCCTTCTTGACCTGTAGAG -> CCTTCTTGACCTGTAGAGC
ACACGTTGCTGTACTAGGA -> CACGTTGCTGTACTAGGAG
CACGTTGCTGTACTAGGAG -> ACGTTGCTGTACTAGGAGT
ACCGCGAGCGGGTGCAACG -> CCGCGAGCGGGTGCAACGT
TATGGCTAATGCTTTCTTG -> ATGGCTAATGCTTTCTTGC
TAGGAGTACCTAATCTGAC -> AGGAGTACCTAATCTGACC
ATGGCCTTCAGCAGAACGC -> TGGCCTTCAGCAGAACGCC
GTAAGTGTACCAGTTGTTT -> TAAGTGTACCAGTTGTTTA
CGCGAGCGGGTGTACATTT -> GCGAGCGGGTGTACATTTA
TGGTTTGTGGCGAATCGCT -> GGTTTGTGGCGAATCGCTG
CCTATTGTCTCCACAGCAA -> CTATTGTCTCCACAGCAAT
TGTACTGGGTAACCCATAG -> GTACTGGGTAACCCATAGA
CTACAACAACTCCTGACTG -> TACAACAACTCCTGACTGC
GTAACCGTTCGTTGTCCTC -> TAACCGTTCGTTGTCCTCA
TTGCGCAGAGGGCGCCCCA -> TGCGCAGAGGGCGCCCCAA
ATCTGACCAATCTAATTAG -> TCTGACCAATCTAATTAGC
ATTGTCTCCACAGCAATTT -> TTGTCTCCACAGCAATTTG
GGTCCGTGCATGGAGTATA -> GTCCGTGCATGGAGTATAG
ATACCGCATGCATCTTTTA -> TACCGCATGCATCTTTTAA
GATGGGATGCGTCACTTAG -> ATGGGATGCGTCACTTAGC
TCCAACTCCGTACGAATCA -> CCAACTCCGTACGAATCAC
ACGAAATCCACCGCCATTG -> CGAAATCCACCGCCATTGT
TGGCGAATCGCTGGCGACG -> GGCGAATCGCTGGCGACGC
TTGTCCTCAACTCCGTGGC -> TGTCCTCAACTCCGTGGCG
GCTACGAGAGGGCCGCCGC -> CTACGAGAGGGCCGCCGCA
TGTACTAGGAGTACCTAAT -> GTACTAGGAGTACCTAATC
TTCGTTTCTACCGAACAGA -> TCGTTTCTACCGAACAGAT
GTCCTTCTTGACCTGTAGA -> TCCTTCTTGACCTGTAGAG
CCAACGATGGATTCCACCG -> CAACGATGGATTCCACCGA
CAGAGCCCGTTTGCCTGGA -> AGAGCCCGTTTGCCTGGAT
GCAGTGCATTGGATTACGG -> CAGTGCATTGGATTACGGC
TCTGGGAGCGAAGCACTGA -> CTGGGAGCGAAGCACTGAC
GTACTAGGAGTACCTAATC -> TACTAGGAGTACCTAATCT
ATTCTGGGCTAAGCCTTGG -> TTCTGGGCTAAGCCTTGGA
GAAGCCGGGATTTAATAGC -> AAGCCGGGATTTAATAGCA
GGACCCCCAACGATGGATT -> GACCCCCAACGATGGATTC
GGTAACCGTTCGTTGTCCT -> GTAACCGTTCGTTGTCCTC
GTAATATAAGTGCCCATTT -> TAATATAAGTGCCCATTTG
CTTCGTTTCTACCGAACAG -> TTCGTTTCTACCGAACAGA
CCCAAATTAATACCGGAAC -> CCAAATTAATACCGGAACC
TTATCGAAGCCGGGATTTA -> TATCGAAGCCGGGATTTAA
GTCTGTATTGCTTTGGTTT -> TCTGTATTGCTTTGGTTTG
ATGCGATCAAAGTGCGTTC -> TGCGATCAAAGTGCGTTCG
TAACAAACCCTCTCCTCCT -> AACAAACCCTCTCCTCCTG
CGATGGAGTAATGGAGTTA -> GATGGAGTAATGGAGTTAT
GCTGTACTAGGAGTACCTA -> CTGTACTAGGAGTACCTAA
GATGGATTCCACCGAACCC -> ATGGATTCCACCGAACCCG
TAGCTGATGTAGGGCTACG -> AGCTGATGTAGGGCTACGA
TGCATGGAGTATAGCCGCT -> GCATGGAGTATAGCCGCTT
GAGTTGGCATGCGCCGAAT -> AGTTGGCATGCGCCGAATC
CTTTGAACATGGCCTTCAG -> TTTGAACATGGCCTTCAGC
ATGGGACAGTCCTAATGTA -> TGGGACAGTCCTAATGTAG
CTTCAGCAGAACGCCCGGT -> TTCAGCAGAACGCCCGGTC
CCTTCAGCAGAACGCCCGG -> CTTCAGCAGAACGCCCGGT
CTTTATATCGACTGATGAG -> TTTATATCGACTGATGAGG
AGGGTCCTGTGGACAGGAA -> GGGTCCTGTGGACAGGAAT
CCCACCGGCAGGGTACCTC -> CCACCGGCAGGGTACCTCT
GGGTAGTATAGCCCTGGCG -> GGTAGTATAGCCCTGGCGG
CACGAAATCCACCGCCATT -> ACGAAATCCACCGCCATTG
ACCGTTCGTTGTCCTCAAC -> CCGTTCGTTGTCCTCAACT
CCAACGTTCGGGCGGTCGG -> CAACGTTCGGGCGGTCGGT
ACGCGCAACACGTTGCTGT -> CGCGCAACACGTTGCTGTA
AGCTGATGTAGGGCTACGA -> GCTGATGTAGGGCTACGAG
TGGCGACGCAGGAGTACCT -> GGCGACGCAGGAGTACCTT
TAGCGATGAATCCTGTAAC -> AGCGATGAATCCTGTAACA
ATGGATTCCACCGAACCCG -> TGGATTCCACCGAACCCGT
TGGCACGGTCATGGGACAG -> GGCACGGTCATGGGACAGT
GCTCCAACTCCGTACGAAT -> CTCCAACTCCGTACGAATC
TCATTCAAGGAGCCACTAG -> CATTCAAGGAGCCACTAGT
ATCCTAACTTTATCATATG -> TCCTAACTTTATCATATGC
ATTTAAACAATAAGGGCCT -> TTTAAACAATAAGGGCCTT
CCACCTAATTCTGGGCTAA -> CACCTAATTCTGGGCTAAG
GGTAAGTGTACCAGTTGTT -> GTAAGTGTACCAGTTGTTT
ATAGCTAATAACGGTAACC -> TAGCTAATAACGGTAACCG
ATTCCACCGAACCCGTACC -> TTCCACCGAACCCGTACCG
CTAGTCTGTAACGGTCCGT -> TAGTCTGTAACGGTCCGTG
TACAGAGCTCGTAGAACCA -> ACAGAGCTCGTAGAACCAC
CTACCGAACAGATTTCCTT -> TACCGAACAGATTTCCTTT
ACTAGTCTGTATTGCTTTG -> CTAGTCTGTATTGCTTTGG
CAAGGGATCGTAGACCACC -> AAGGGATCGTAGACCACCT
GCGCCCCAACGTTCGGGCG -> CGCCCCAACGTTCGGGCGG
CGAGCGGGTGCAACGTATC -> GAGCGGGTGCAACGTATCA
AATCTGACCAATCTAATTA -> ATCTGACCAATCTAATTAG
GAACAGATTTCCTTTAGCT -> AACAGATTTCCTTTAGCTG
AGACGCAGGACGTAGTAGA -> GACGCAGGACGTAGTAGAA
ATTCAAGGAGCCACTAGTC -> TTCAAGGAGCCACTAGTCT,TTCAAGGAGCCACTAGTCT
TACTAGGAGTACCTAATCT -> ACTAGGAGTACCTAATCTG
CCTGGATTTTACCCTCCTA -> CTGGATTTTACCCTCCTAA
TCCCGAGTTTTTTGTACGG -> CCCGAGTTTTTTGTACGGA
ATGTTAAGGTCAGTCTTGA -> TGTTAAGGTCAGTCTTGAG
CCACTTGCTACCATAGTTT -> CACTTGCTACCATAGTTTA
GTCCGATACCCTCGAATGC -> TCCGATACCCTCGAATGCA
ATTGGAGAACCAGGCGCTT -> TTGGAGAACCAGGCGCTTT
TACCATCAAGGAGCCACTA -> ACCATCAAGGAGCCACTAG
CCTAAGGTCATAGCCGTTG -> CTAAGGTCATAGCCGTTGC
ACCACCCACTTTGCCTTGT -> CCACCCACTTTGCCTTGTG
CTCTTTATGTTAGCACTTT -> TCTTTATGTTAGCACTTTA
GCCACTAGTCTGTATTGCT -> CCACTAGTCTGTATTGCTT
TGACGACCGAACTGACTAC -> GACGACCGAACTGACTACA
GAGGACATGTCCAAGCAGA -> AGGACATGTCCAAGCAGAA
GCCTCGATCAAAACTCGCC -> CCTCGATCAAAACTCGCCG
GACCTCTTGAGCACGCAGG -> ACCTCTTGAGCACGCAGGG
GCATTACAGAGCTCGTAGA -> CATTACAGAGCTCGTAGAA
TTCTTGCCCACGTCCATCC -> TCTTGCCCACGTCCATCCA
GGAATTAGGACACTCCTAT -> GAATTAGGACACTCCTATT
GGTCTCTTTATGTTAGCAC -> GTCTCTTTATGTTAGCACT
GGCTACGAGAGGGCCGCCG -> GCTACGAGAGGGCCGCCGC
TGCCCACGTCCATCCACTT -> GCCCACGTCCATCCACTTG
AATCACTGCTACAACAACT -> ATCACTGCTACAACAACTC
CTGGGTAACCCATAGAAAT -> TGGGTAACCCATAGAAATG
AGAACGCCCGGTCGGATAT -> GAACGCCCGGTCGGATATA
CCAAGCAGAATTGCTCAAA -> CAAGCAGAATTGCTCAAAC
GTGTGCACCTGTAATTATG -> TGTGCACCTGTAATTATGA
CTAATGTAGACGCAGGACG -> TAATGTAGACGCAGGACGT
CATGTCCAAGCAGAATTGC -> ATGTCCAAGCAGAATTGCT
TAGCCGTTGCTTTCCCGAG -> AGCCGTTGCTTTCCCGAGT
GCACGGTCATGGGACAGTC -> CACGGTCATGGGACAGTCC
CAACAACTCCTGACTGCTA -> AACAACTCCTGACTGCTAT
GACCCCCAACGATGGATTC -> ACCCCCAACGATGGATTCC
CCTGTGGACAGGAATAGTG -> CTGTGGACAGGAATAGTGA
CCGACGTTATCGAAGCCGG -> CGACGTTATCGAAGCCGGG
TGATACCGCATGCATCTTT -> GATACCGCATGCATCTTTT
CTTTCAACACCGTACCGCG -> TTTCAACACCGTACCGCGA
ACTCCCCAAATTAATACCG -> CTCCCCAAATTAATACCGG
CAGGGACTTTATATCGACT -> AGGGACTTTATATCGACTG
GCACTTTAAATTAGCAGTG -> CACTTTAAATTAGCAGTGC
ATAGCAAGGGATCGTAGAC -> TAGCAAGGGATCGTAGACC
TGGGTAACCCATAGAAATG -> GGGTAACCCATAGAAATGT
CCTCGATCAAAACTCGCCG -> CTCGATCAAAACTCGCCGA
ATTAGCCCGGCTCGCGTGT -> TTAGCCCGGCTCGCGTGTG
TTGCCCCACGTAACCTTGG -> TGCCCCACGTAACCTTGGT
TTTGCCTTGTGCGTATCCT -> TTGCCTTGTGCGTATCCTA
GCACCTGTAATTATGACCT -> CACCTGTAATTATGACCTA
GAACCTTACAGTTATCCGA -> AACCTTACAGTTATCCGAC
CTGATGAGGGTTAATCTCG -> TGATGAGGGTTAATCTCGA
AATGGAGTTATATTATGGA -> ATGGAGTTATATTATGGAA
ACGCAGGACGTAGTAGAAG -> CGCAGGACGTAGTAGAAGC
TTGGTTTGTGGCGAATCGC -> TGGTTTGTGGCGAATCGCT
TCTTTTAAGGCGCCTCGAT -> CTTTTAAGGCGCCTCGATC
TAGTTTGACGACCGAACTG -> AGTTTGACGACCGAACTGA
CGCTATTCAATCTTGACTC -> GCTATTCAATCTTGACTCA
ACGGGCTCCAACTCCGTAC -> CGGGCTCCAACTCCGTACG
ATCGTAGAGGGTAGTATAG -> TCGTAGAGGGTAGTATAGC
TAGGGACCCGTTGAGTTCC -> AGGGACCCGTTGAGTTCCA
ATCTGCCCAGTGCAACAAT -> TCTGCCCAGTGCAACAATA
CTAGTCTGTATTGCTTTGG -> TAGTCTGTATTGCTTTGGT
TTAGCTGATGTAGGGCTAC -> TAGCTGATGTAGGGCTACG
TTTAAACAATAAGGGCCTT -> TTAAACAATAAGGGCCTTC
GCGACGCAGGAGTACCTTC -> CGACGCAGGAGTACCTTCA
GCGAACGAAACCACGATGG -> CGAACGAAACCACGATGGA
CTCTATTACGATAGGTAGT -> TCTATTACGATAGGTAGTA
GAGCCACAAACAAACGGGA -> AGCCACAAACAAACGGGAC
AGGAGCCACTAGTCTGACC -> GGAGCCACTAGTCTGACCT
ACTTGCTACCATAGTTTAG -> CTTGCTACCATAGTTTAGG
TTGGCATGCGCCGAATCAA -> TGGCATGCGCCGAATCAAC
GGACGTAGTAGAAGCCGCA -> GACGTAGTAGAAGCCGCAG
CACTGACGACGTAGTTTGA -> ACTGACGACGTAGTTTGAC
GTAGGGCTACGAGAGGGCC -> TAGGGCTACGAGAGGGCCG
CAAACAAACGGGACGCTAC -> AAACAAACGGGACGCTACG
GTGCAACAATAATTCAGAG -> TGCAACAATAATTCAGAGT
GCCACTAGTCTGTAACGGT -> CCACTAGTCTGTAACGGTC
GACTGATGAGGGTTAATCT -> ACTGATGAGGGTTAATCTC
CCAACTCCGTACGAATCAC -> CAACTCCGTACGAATCACT
CGGCAGGGTACCTCTCGTC -> GGCAGGGTACCTCTCGTCT
TACATCTCGCTTAGCGATG -> ACATCTCGCTTAGCGATGA
CGCCGAAGACGCTATTCAA -> GCCGAAGACGCTATTCAAT
GCTCACCCACGAAATCCAC -> CTCACCCACGAAATCCACC
TAACGGTCCGTGCATGGAG -> AACGGTCCGTGCATGGAGT
GGACGAGTTGGCATGCGCC -> GACGAGTTGGCATGCGCCG
ACAGTTATCCGACGTTATC -> CAGTTATCCGACGTTATCG
GGACAGGAATAGTGACGCT -> GACAGGAATAGTGACGCTG
CCACTAGTCTGTATATCCG -> CACTAGTCTGTATATCCGT
CCTCCCAATGACTATGGCT -> CTCCCAATGACTATGGCTA
GGCGCCCCAACGTTCGGGC -> GCGCCCCAACGTTCGGGCG
CCACCGTGGCTGCACCTGT -> CACCGTGGCTGCACCTGTC
ACTGATGAGGGTTAATCTC -> CTGATGAGGGTTAATCTCG
CTTTAGCTGATGTAGGGCT -> TTTAGCTGATGTAGGGCTA
GGGATCGTAGACCACCTAA -> GGATCGTAGACCACCTAAT
ACATGTCCAAGCAGAATTG -> CATGTCCAAGCAGAATTGC
CCGCTAGGATGTCCTTCTT -> CGCTAGGATGTCCTTCTTG
CGTCCGATACCCTCGAATG -> GTCCGATACCCTCGAATGC
ATCCGACGTTATCGAAGCC -> TCCGACGTTATCGAAGCCG
GTTGCTTTCCCGAGTTTTT -> TTGCTTTCCCGAGTTTTTT
TCTTGAGATGATACCGCAT -> CTTGAGATGATACCGCATG
GTACCATAGATCGGCTTAA -> TACCATAGATCGGCTTAAG
GAACGCCCGGTCGGATATA -> AACGCCCGGTCGGATATAC
CGTTCGGGCGGTCGGTCCA -> GTTCGGGCGGTCGGTCCAT
AACTCTATTACGATAGGTA -> ACTCTATTACGATAGGTAG
AGCTAATAACGGTAACCGT -> GCTAATAACGGTAACCGTT
GACGCTATTCAATCTTGAC -> ACGCTATTCAATCTTGACT
TTTAAGGCGCCTCGATCAA -> TTAAGGCGCCTCGATCAAA
ACGTTCGGGCGGTCGGTCC -> CGTTCGGGCGGTCGGTCCA
CGGAACCTCGGTCTCTTTA -> GGAACCTCGGTCTCTTTAT
TAGCAAGGGATCGTAGACC -> AGCAAGGGATCGTAGACCA
TACCTAATCTGACCAATCT -> ACCTAATCTGACCAATCTA
CGGACGAGTTGGCATGCGC -> GGACGAGTTGGCATGCGCC
GAATTGCTCAAACGGGCTC -> AATTGCTCAAACGGGCTCC
GGAGTACATTTAAACAATA -> GAGTACATTTAAACAATAA
GAGCTTCAAAGGATGCTAA -> AGCTTCAAAGGATGCTAAG
ACCTATATCCGCGGCCGAT -> CCTATATCCGCGGCCGATC
ACTGACTACACATTTCTGA -> CTGACTACACATTTCTGAA
ATCTAATTAGCCCGGCTCG -> TCTAATTAGCCCGGCTCGC
CTCCTGTACTGGGTAACCC -> TCCTGTACTGGGTAACCCA
TGGGCTAAGCCTTGGACCA -> GGGCTAAGCCTTGGACCAC
CCGTTCGTTGTCCTCAACT -> CGTTCGTTGTCCTCAACTC
AGTGTACCAGTTGTTTATG -> GTGTACCAGTTGTTTATGT
CAGCCAGCGAACGAAACCA -> AGCCAGCGAACGAAACCAC
TGAGGGTTAATCTCGACAA -> GAGGGTTAATCTCGACAAA
ACTATGGCTAATGCTTTCT -> CTATGGCTAATGCTTTCTT
CCATCCACTTGCTACCATA -> CATCCACTTGCTACCATAG
TTATGTTTTCCTACCAAGA -> TATGTTTTCCTACCAAGAT
AATCCACCGCCATTGTGAT -> ATCCACCGCCATTGTGATA
AAACCCTCTCCTCCTGTAC -> AACCCTCTCCTCCTGTACT
CGCCCCAACGTTCGGGCGG -> GCCCCAACGTTCGGGCGGT
GGCGAATCGCTGGCGACGC -> GCGAATCGCTGGCGACGCA
GCTCGTAGAACCACACCTA -> CTCGTAGAACCACACCTAA
CTAATCTGCCGTCGTCCGA -> TAATCTGCCGTCGTCCGAT
CGTACGAATCACTGCTACA -> GTACGAATCACTGCTACAA
CCGAACAGATTTCCTTTAG -> CGAACAGATTTCCTTTAGC
AACGTATCATTCAAGGAGC -> ACGTATCATTCAAGGAGCC
CAGAGTGCGAATACGCGCA -> AGAGTGCGAATACGCGCAA
CTTCTTGACCTGTAGAGCT -> TTCTTGACCTGTAGAGCTA
CTCCTCCTGTACTGGGTAA -> TCCTCCTGTACTGGGTAAC
ACCGTACCGCGAGCGGGTG -> CCGTACCGCGAGCGGGTGA
GGGTCCTGTGGACAGGAAT -> GGTCCTGTGGACAGGAATA
GACCACTTCCGTACCGCGA -> ACCACTTCCGTACCGCGAG
GCATTATAGGAATTTTGTT -> CATTATAGGAATTTTGTTT
ATATCGACTGATGAGGGTT -> TATCGACTGATGAGGGTTA
CACCGTGGCTGCACCTGTC -> ACCGTGGCTGCACCTGTCG
TGACTATGGCTAATGCTTT -> GACTATGGCTAATGCTTTC
GAGAGGGCCGCCGCATCTG -> AGAGGGCCGCCGCATCTGC
TGTCTCCACAGCAATTTGG -> GTCTCCACAGCAATTTGGA
CCAGAAAACAATACTACGG -> CAGAAAACAATACTACGGA
CGTATCATTCAAGGAGCCA -> GTATCATTCAAGGAGCCAC
GATCAAAGTGCGTTCGGGC -> ATCAAAGTGCGTTCGGGCC
ATAAGCTCACCCACGAAAT -> TAAGCTCACCCACGAAATC
CGTGCATGGAGTATAGCCG -> GTGCATGGAGTATAGCCGC
CAGTTGTTTATGTTTTCCT -> AGTTGTTTATGTTTTCCTA
GATTGGAGAACCAGGCGCT -> ATTGGAGAACCAGGCGCTT
CCACACCTAATGCAGCCGC -> CACACCTAATGCAGCCGCC
AGCGGGTGGAGCGCGGGTA -> GCGGGTGGAGCGCGGGTAT
AGTTTTTTGTACGGAACCT -> GTTTTTTGTACGGAACCTC
TAAGTAATATAAGTGCCCA -> AAGTAATATAAGTGCCCAT
ACGGTAACCGTTCGTTGTC -> CGGTAACCGTTCGTTGTCC
AGCAATTTGGAAGCCTTCG -> GCAATTTGGAAGCCTTCGA
GTCATAGCCGTTGCTTTCC -> TCATAGCCGTTGCTTTCCC
AGTTGTTTATGTTTTCCTA -> GTTGTTTATGTTTTCCTAC
AGTCGAATTCGATTGCGCA -> GTCGAATTCGATTGCGCAG
CTTTTAAGGCGCCTCGATC -> TTTTAAGGCGCCTCGATCA
TGGATTCCACCGAACCCGT -> GGATTCCACCGAACCCGTA
CTCGAATGCATTACAGAGC -> TCGAATGCATTACAGAGCT
TTTGAATACTCCCCAAATT -> TTGAATACTCCCCAAATTA
TAGGAATTTTGTTTGCCCC -> AGGAATTTTGTTTGCCCCA
TTGACTCAATCTCAGTCGA -> TGACTCAATCTCAGTCGAA
CCTAAACCAGAAAACAATA -> CTAAACCAGAAAACAATAC
GGGATTTAATAGCAAGGGA -> GGATTTAATAGCAAGGGAT
GACAAATTTGTGTACCATA -> ACAAATTTGTGTACCATAG
CTAATGCAGCCGCCGACCA -> TAATGCAGCCGCCGACCAC
GTACCTCTCGTCTGGTGAC -> TACCTCTCGTCTGGTGACT
ATGATACCGCATGCATCTT -> TGATACCGCATGCATCTTT
TTGGACCACTTCCGTACCG -> TGGACCACTTCCGTACCGC
CGAAGACGCTATTCAATCT -> GAAGACGCTATTCAATCTT
GCCTTCGTTTCTACCGAAC -> CCTTCGTTTCTACCGAACA
GCGCGGGTATCAAGGAGCC -> CGCGGGTATCAAGGAGCCA
CCACCGGCAGGGTACCTCT -> CACCGGCAGGGTACCTCTC
GCATTGGATTACGGCATTA -> CATTGGATTACGGCATTAT
TGCTACAACAACTCCTGAC -> GCTACAACAACTCCTGACT
TAACCCATAGAAATGTTAA -> AACCCATAGAAATGTTAAG
ATTGTGATAGCTAATAACG -> TTGTGATAGCTAATAACGG
AATTTGTGTACCATAGATC -> ATTTGTGTACCATAGATCG
CATATGCGATCAAAGTGCG -> ATATGCGATCAAAGTGCGT
ACTCTATTACGATAGGTAG -> CTCTATTACGATAGGTAGT
CATGGAGTATAGCCGCTTA -> ATGGAGTATAGCCGCTTAC
ACTTATGCCGTACCGCGAG -> CTTATGCCGTACCGCGAGC
AACATGGCCTTCAGCAGAA -> ACATGGCCTTCAGCAGAAC
GGCCGATCCGGACGAGTTG -> GCCGATCCGGACGAGTTGG
ATCTCGCTTAGCGATGAAT -> TCTCGCTTAGCGATGAATC
GACATGTCCAAGCAGAATT -> ACATGTCCAAGCAGAATTG
ACGACCGAACTGACTACAC -> CGACCGAACTGACTACACA
CAAAGGATGCTAAGATAAG -> AAAGGATGCTAAGATAAGC
TACCGCGAGCGGGTGCAAC -> ACCGCGAGCGGGTGCAACG
GGTCATGGGACAGTCCTAA -> GTCATGGGACAGTCCTAAT
GCTTAGCGATGAATCCTGT -> CTTAGCGATGAATCCTGTA
GCCGGGATTTAATAGCAAG -> CCGGGATTTAATAGCAAGG
CGTACCGCGAGCGGGTGGA -> GTACCGCGAGCGGGTGGAG
TCGATCAAAACTCGCCGAA -> CGATCAAAACTCGCCGAAG
ACATTTACCATCAAGGAGC -> CATTTACCATCAAGGAGCC
AAGCCGGGATTTAATAGCA -> AGCCGGGATTTAATAGCAA
GTGACGCTGATCACACCAC -> TGACGCTGATCACACCACC
ATACCGGAACCTTACAGTT -> TACCGGAACCTTACAGTTA
CCGTACCGCGAGCGGGTGA -> CGTACCGCGAGCGGGTGAC
TTATAGGAATTTTGTTTGC -> TATAGGAATTTTGTTTGCC
GGGACGCTACGAAGCTGAT -> GGACGCTACGAAGCTGATC
AGTTTAGGGACCCGTTGAG -> GTTTAGGGACCCGTTGAGT
ACTACGGATTGGAGAACCA -> CTACGGATTGGAGAACCAG
ACCTGTAGAGCTACCTATA -> CCTGTAGAGCTACCTATAT
TTGGATTACGGCATTATAG -> TGGATTACGGCATTATAGG
GTGGCTGCACCTGTCGACC -> TGGCTGCACCTGTCGACCA
GGGCCGCCGCATCTGCCCA -> GGCCGCCGCATCTGCCCAG
GAGTAATGGAGTTATATTA -> AGTAATGGAGTTATATTAT
ACTGCCGCTAGGATGTCCT -> CTGCCGCTAGGATGTCCTT
CTTACAGTTATCCGACGTT -> TTACAGTTATCCGACGTTA
TTGCTCAAACGGGCTCCAA -> TGCTCAAACGGGCTCCAAC
GTAGTATAGCCCTGGCGGA -> TAGTATAGCCCTGGCGGAC
ATAGCCCTGGCGGACCCCC -> TAGCCCTGGCGGACCCCCA
AACCTCGGTCTCTTTATGT -> ACCTCGGTCTCTTTATGTT
TTATCCGACGTTATCGAAG -> TATCCGACGTTATCGAAGC
CCTTCAGCAGCCAGCGAAC -> CTTCAGCAGCCAGCGAACG
TCTGTAACGGTCCGTGCAT -> CTGTAACGGTCCGTGCATG
TCGGTCTCTTTATGTTAGC -> CGGTCTCTTTATGTTAGCA
GAATCGCTGGCGACGCAGG -> AATCGCTGGCGACGCAGGA
CCACGATGGAGTAATGGAG -> CACGATGGAGTAATGGAGT
CGCAGAGGGCGCCCCAACG -> GCAGAGGGCGCCCCAACGT
CTGCCGCTAGGATGTCCTT -> TGCCGCTAGGATGTCCTTC
AGTCTGACCTCTTGAGCAC -> GTCTGACCTCTTGAGCACG
ACGAAGCTGATCGAGAGGA -> CGAAGCTGATCGAGAGGAC
GAATCACTGCTACAACAAC -> AATCACTGCTACAACAACT
TGCTTTCTTGCCCACGTCC -> GCTTTCTTGCCCACGTCCA
TATTCAATCTTGACTCAAT -> ATTCAATCTTGACTCAATC
CTAATTTGAATACTCCCCA -> TAATTTGAATACTCCCCAA
TCGCTGGCGACGCAGGAGT -> CGCTGGCGACGCAGGAGTA
TGGCTAATGCTTTCTTGCC -> GGCTAATGCTTTCTTGCCC
ACAATAAGGGCCTTCAGCA -> CAATAAGGGCCTTCAGCAG
TATTATGGAATTAGGACAC -> ATTATGGAATTAGGACACT
TAAACAATAAGGGCCTTCA -> AAACAATAAGGGCCTTCAG
AGATAAGCTCACCCACGAA -> GATAAGCTCACCCACGAAA
CCATTTGTATTTAAAGATC -> CATTTGTATTTAAAGATCG
CTTCCGTACCGCGAGCGGG -> TTCCGTACCGCGAGCGGGT
TATACGGTTGGCACGGTCA -> ATACGGTTGGCACGGTCAT
TAACCTTGGTAAGTGTACC -> AACCTTGGTAAGTGTACCA
CCCTCGAATGCATTACAGA -> CCTCGAATGCATTACAGAG
GGATATACGGTTGGCACGG -> GATATACGGTTGGCACGGT
AATGTAGACGCAGGACGTA -> ATGTAGACGCAGGACGTAG
CATTACAGAGCTCGTAGAA -> ATTACAGAGCTCGTAGAAC
CCGTGGCGTGAACTCTATT -> CGTGGCGTGAACTCTATTA
CTGACGACGTAGTTTGACG -> TGACGACGTAGTTTGACGA
GGCATTATAGGAATTTTGT -> GCATTATAGGAATTTTGTT
CGTTTCTACCGAACAGATT -> GTTTCTACCGAACAGATTT
TTCCACTTCGCCTTCGTTT -> TCCACTTCGCCTTCGTTTC
ACGCCCGGTCGGATATACG -> CGCCCGGTCGGATATACGG
GGCTTAAGTAATATAAGTG -> GCTTAAGTAATATAAGTGC
GTCGTCCGATACCCTCGAA -> TCGTCCGATACCCTCGAAT
ACTAATTTGAATACTCCCC -> CTAATTTGAATACTCCCCA
GCTGATCGAGAGGACATGT -> CTGATCGAGAGGACATGTC
CTCAATCTCAGTCGAATTC -> TCAATCTCAGTCGAATTCG
ATTTCCTTTAGCTGATGTA -> TTTCCTTTAGCTGATGTAG
GCATCTTTTAAGGCGCCTC -> CATCTTTTAAGGCGCCTCG
AAACAATACTACGGATTGG -> AACAATACTACGGATTGGA
GGAGAACCAGGCGCTTTGA -> GAGAACCAGGCGCTTTGAA
TTAATCTCGACAAATTTGT -> TAATCTCGACAAATTTGTG
CCGCTTACCTAAACCAGAA -> CGCTTACCTAAACCAGAAA
CAGTGCAACAATAATTCAG -> AGTGCAACAATAATTCAGA
ATATCCGTCGGGAGTACAT -> TATCCGTCGGGAGTACATT
GGACCACTTCCGTACCGCG -> GACCACTTCCGTACCGCGA
AGGGACTTTATATCGACTG -> GGGACTTTATATCGACTGA
ATAGGTAGTACATCTCGCT -> TAGGTAGTACATCTCGCTT
ACTTCGCCTTCGTTTCTAC -> CTTCGCCTTCGTTTCTACC
TAATCTGCCGTCGTCCGAT -> AATCTGCCGTCGTCCGATA
GGTGACTTATGCCGTACCG -> GTGACTTATGCCGTACCGC
TCTCTTTATGTTAGCACTT -> CTCTTTATGTTAGCACTTT
ACCGGAACCTTACAGTTAT -> CCGGAACCTTACAGTTATC
ATTTGTGTACCATAGATCG -> TTTGTGTACCATAGATCGG
AAACGGGACGCTACGAAGC -> AACGGGACGCTACGAAGCT
TTATGGAATTAGGACACTC -> TATGGAATTAGGACACTCC
GTCGGGAGTACATTTAAAC -> TCGGGAGTACATTTAAACA
CACTTCCGTACCGCGAGCG -> ACTTCCGTACCGCGAGCGG
GCAGGACGTAGTAGAAGCC -> CAGGACGTAGTAGAAGCCG
GTGTACCAGTTGTTTATGT -> TGTACCAGTTGTTTATGTT
ACCGCCATTGTGATAGCTA -> CCGCCATTGTGATAGCTAA
TCTCGACAAATTTGTGTAC -> CTCGACAAATTTGTGTACC
TGCTTTGGTTTGTGGCGAA -> GCTTTGGTTTGTGGCGAAT
ACCCGATAGAGCCACAAAC -> CCCGATAGAGCCACAAACA
GACGTAGTTTGACGACCGA -> ACGTAGTTTGACGACCGAA
GGAGTACCTAATCTGACCA -> GAGTACCTAATCTGACCAA
TAATAGCAAGGGATCGTAG -> AATAGCAAGGGATCGTAGA
CGCTAGGATGTCCTTCTTG -> GCTAGGATGTCCTTCTTGA
GTATCCTAACTTTATCATA -> TATCCTAACTTTATCATAT
CTCCCCAAATTAATACCGG -> TCCCCAAATTAATACCGGA
TTACAGTTATCCGACGTTA -> TACAGTTATCCGACGTTAT
CTCACCCACGAAATCCACC -> TCACCCACGAAATCCACCG
GCCGCTAGGATGTCCTTCT -> CCGCTAGGATGTCCTTCTT
TGCCGTACCGCGAGCGGGT -> GCCGTACCGCGAGCGGGTG
TGTAGACGCAGGACGTAGT -> GTAGACGCAGGACGTAGTA
GACCAGATGGGATGCGTCA -> ACCAGATGGGATGCGTCAC
TCGGGCCTCCCAATGACTA -> CGGGCCTCCCAATGACTAT
TGGAGCGCGGGTATCAAGG -> GGAGCGCGGGTATCAAGGA
AAGGAGCCACTAGTCTGAC -> AGGAGCCACTAGTCTGACC
TCTCAGTCGAATTCGATTG -> CTCAGTCGAATTCGATTGC
GAGTATAGCCGCTTACCTA -> AGTATAGCCGCTTACCTAA
CTGTAATTATGACCTAATC -> TGTAATTATGACCTAATCT
GTTAATCTCGACAAATTTG -> TTAATCTCGACAAATTTGT
GTTATCGAAGCCGGGATTT -> TTATCGAAGCCGGGATTTA
TTCAAGGAGCCACTAGTCT -> TCAAGGAGCCACTAGTCTG,TCAAGGAGCCACTAGTCTG
CATAGCCGTTGCTTTCCCG -> ATAGCCGTTGCTTTCCCGA
GGTCCATTCGAATGCTGCA -> GTCCATTCGAATGCTGCAC
GGCGGTCGGTCCATTCGAA -> GCGGTCGGTCCATTCGAAT
GTTGTCCTCAACTCCGTGG -> TTGTCCTCAACTCCGTGGC
ATTGCGCAGAGGGCGCCCC -> TTGCGCAGAGGGCGCCCCA
TTGAGTTCCATTCCACTTC -> TGAGTTCCATTCCACTTCG
TATCATTCAAGGAGCCACT -> ATCATTCAAGGAGCCACTA
TTACCATCAAGGAGCCACT -> TACCATCAAGGAGCCACTA
AGAAATGTTAAGGTCAGTC -> GAAATGTTAAGGTCAGTCT
CGCCTTCGTTTCTACCGAA -> GCCTTCGTTTCTACCGAAC
TATCGAAGCCGGGATTTAA -> ATCGAAGCCGGGATTTAAT
GTTGTTTATGTTTTCCTAC -> TTGTTTATGTTTTCCTACC
TCGTAGACCACCTAATTCT -> CGTAGACCACCTAATTCTG
CGGGTATCAAGGAGCCACT -> GGGTATCAAGGAGCCACTA
AGGAGCCACTAGTCTGTAA -> GGAGCCACTAGTCTGTAAC
CACACCACCCACTTTGCCT -> ACACCACCCACTTTGCCTT
CCCCAACGATGGATTCCAC -> CCCAACGATGGATTCCACC
GACCACCGTGGCTGCACCT -> ACCACCGTGGCTGCACCTG
AGGGACCCGTTGAGTTCCA -> GGGACCCGTTGAGTTCCAT
CGAACTGACTACACATTTC -> GAACTGACTACACATTTCT
GATCACACCACCCACTTTG -> ATCACACCACCCACTTTGC
TCATAGCCGTTGCTTTCCC -> CATAGCCGTTGCTTTCCCG
GCAATTCAAGGAGCCACTA -> CAATTCAAGGAGCCACTAG
GCCGCCGCATCTGCCCAGT -> CCGCCGCATCTGCCCAGTG
CTTTCTTGCCCACGTCCAT -> TTTCTTGCCCACGTCCATC
AGGGTTAATCTCGACAAAT -> GGGTTAATCTCGACAAATT
TGGTAAGTGTACCAGTTGT -> GGTAAGTGTACCAGTTGTT
TCGTAGAGGGTAGTATAGC -> CGTAGAGGGTAGTATAGCC
ACATCTCGCTTAGCGATGA -> CATCTCGCTTAGCGATGAA
CGTAGACCACCTAATTCTG -> GTAGACCACCTAATTCTGG
CGCCATTGTGATAGCTAAT -> GCCATTGTGATAGCTAATA
TTATATTATGGAATTAGGA -> TATATTATGGAATTAGGAC
TCCTAAGGTCATAGCCGTT -> CCTAAGGTCATAGCCGTTG
TCTGTATATCCGTCGGGAG -> CTGTATATCCGTCGGGAGT
CTAGGAGTACCTAATCTGA -> TAGGAGTACCTAATCTGAC
CCCACTTTGCCTTGTGCGT -> CCACTTTGCCTTGTGCGTA
GATTTCCTTTAGCTGATGT -> ATTTCCTTTAGCTGATGTA
TTCGGGCGGTCGGTCCATT -> TCGGGCGGTCGGTCCATTC
CTAAGCCTTGGACCACTTC -> TAAGCCTTGGACCACTTCC
TCCTAATGTAGACGCAGGA -> CCTAATGTAGACGCAGGAC
GGGTGGAGCGCGGGTATCA -> GGTGGAGCGCGGGTATCAA
ATTATGGAATTAGGACACT -> TTATGGAATTAGGACACTC
GATAGGTAGTACATCTCGC -> ATAGGTAGTACATCTCGCT
AATCTCAGTCGAATTCGAT -> ATCTCAGTCGAATTCGATT
AGGAATAGTGACGCTGATC -> GGAATAGTGACGCTGATCA
CACTAGTCTGTATATCCGT -> ACTAGTCTGTATATCCGTC
GAACCACACCTAATGCAGC -> AACCACACCTAATGCAGCC
CTCGTATACTTTCAACACC -> TCGTATACTTTCAACACCG
AACGAAACCACGATGGAGT -> ACGAAACCACGATGGAGTA
TGGGACAGTCCTAATGTAG -> GGGACAGTCCTAATGTAGA
CTGTAGAGCTACCTATATC -> TGTAGAGCTACCTATATCC
ACGTCCATCCACTTGCTAC -> CGTCCATCCACTTGCTACC
AACCACACCTAATGCAGCC -> ACCACACCTAATGCAGCCG
AATCTTGACTCAATCTCAG -> ATCTTGACTCAATCTCAGT
TACCTAAACCAGAAAACAA -> ACCTAAACCAGAAAACAAT
GGAACCTTACAGTTATCCG -> GAACCTTACAGTTATCCGA
ATCCGGTCTGGGAGCGAAG -> TCCGGTCTGGGAGCGAAGC
ACGGTCATGGGACAGTCCT -> CGGTCATGGGACAGTCCTA
TACCAGTTGTTTATGTTTT -> ACCAGTTGTTTATGTTTTC
AGTTATCCGACGTTATCGA -> GTTATCCGACGTTATCGAA
TAGCAGTGCATTGGATTAC -> AGCAGTGCATTGGATTACG
AGCAAGGGATCGTAGACCA -> GCAAGGGATCGTAGACCAC
GTGTACATTTACCATCAAG -> TGTACATTTACCATCAAGG
ACCACTTCCGTACCGCGAG -> CCACTTCCGTACCGCGAGC
ATGGAGTAATGGAGTTATA -> TGGAGTAATGGAGTTATAT
GCCTCCCAATGACTATGGC -> CCTCCCAATGACTATGGCT
GCAACGTATCATTCAAGGA -> CAACGTATCATTCAAGGAG
AATGCTTTCTTGCCCACGT -> ATGCTTTCTTGCCCACGTC
CCTCCTAAGGTCATAGCCG -> CTCCTAAGGTCATAGCCGT
TAGCCCACCGGCAGGGTAC -> AGCCCACCGGCAGGGTACC
CAAACGGGCTCCAACTCCG -> AAACGGGCTCCAACTCCGT
AGGAGCCACTAGTCTGTAT -> GGAGCCACTAGTCTGTATA,GGAGCCACTAGTCTGTATT
CCTTCTTGACCTGTAGAGC -> CTTCTTGACCTGTAGAGCT
AACGGTCCGTGCATGGAGT -> ACGGTCCGTGCATGGAGTA
TACCCTCCTAAGGTCATAG -> ACCCTCCTAAGGTCATAGC
AATAGTGACGCTGATCACA -> ATAGTGACGCTGATCACAC
GATCCGGTCTGGGAGCGAA -> ATCCGGTCTGGGAGCGAAG
TAAGGCGCCTCGATCAAAA -> AAGGCGCCTCGATCAAAAC
TAAATTAGCAGTGCATTGG -> AAATTAGCAGTGCATTGGA
CCCGAGTTTTTTGTACGGA -> CCGAGTTTTTTGTACGGAA
GGTAGTACATCTCGCTTAG -> GTAGTACATCTCGCTTAGC
ACGCAGGAGTACCTTCACG -> CGCAGGAGTACCTTCACGC
GCAACAATAATTCAGAGTG -> CAACAATAATTCAGAGTGC
TAATTCTGGGCTAAGCCTT -> AATTCTGGGCTAAGCCTTG
ACGTAGTAGAAGCCGCAGA -> CGTAGTAGAAGCCGCAGAG
GGAATAGTGACGCTGATCA -> GAATAGTGACGCTGATCAC
ATCCTGTAACAAACCCTCT -> TCCTGTAACAAACCCTCTC
TGCTGCACCCGATAGAGCC -> GCTGCACCCGATAGAGCCA
ATCAAAACTCGCCGAAGAC -> TCAAAACTCGCCGAAGACG
ACTCCGTACGAATCACTGC -> CTCCGTACGAATCACTGCT
TCGCGTGTGCACCTGTAAT -> CGCGTGTGCACCTGTAATT
AACGTTCGGGCGGTCGGTC -> ACGTTCGGGCGGTCGGTCC
GAAGACGCTATTCAATCTT -> AAGACGCTATTCAATCTTG
CCACTTCCGTACCGCGAGC -> CACTTCCGTACCGCGAGCG
TCTTGAGCACGCAGGGTCC -> CTTGAGCACGCAGGGTCCT
CTATTGTCTCCACAGCAAT -> TATTGTCTCCACAGCAATT
CCGAGTTTTTTGTACGGAA -> CGAGTTTTTTGTACGGAAC
TAATTTGAATACTCCCCAA -> AATTTGAATACTCCCCAAA
CGCCGAATCAACTTCAGGG -> GCCGAATCAACTTCAGGGA
TGGCCTTCAGCAGAACGCC -> GGCCTTCAGCAGAACGCCC
GAGCCCGTTTGCCTGGATT -> AGCCCGTTTGCCTGGATTT
GGGCGCCCCAACGTTCGGG -> GGCGCCCCAACGTTCGGGC
CCATAGATCGGCTTAAGTA -> CATAGATCGGCTTAAGTAA
ACCGAACTGACTACACATT -> CCGAACTGACTACACATTT
ATGAATCCTGTAACAAACC -> TGAATCCTGTAACAAACCC
AATAACGGTAACCGTTCGT -> ATAACGGTAACCGTTCGTT
CAACTCCGTGGCGTGAACT -> AACTCCGTGGCGTGAACTC
CGTCGTCCGATACCCTCGA -> GTCGTCCGATACCCTCGAA
CACTAGTCTGACCTCTTGA -> ACTAGTCTGACCTCTTGAG
GACCGAACTGACTACACAT -> ACCGAACTGACTACACATT
GGGACCCGTTGAGTTCCAT -> GGACCCGTTGAGTTCCATT
GCCTGGATTTTACCCTCCT -> CCTGGATTTTACCCTCCTA
CTTCACGCGATCCGGTCTG -> TTCACGCGATCCGGTCTGG
TCAATCTTGACTCAATCTC -> CAATCTTGACTCAATCTCA
GTTGCTGTACTAGGAGTAC -> TTGCTGTACTAGGAGTACC
CCCTGGCGGACCCCCAACG -> CCTGGCGGACCCCCAACGA
CTCCACAGCAATTTGGAAG -> TCCACAGCAATTTGGAAGC
GCGATCCGGTCTGGGAGCG -> CGATCCGGTCTGGGAGCGA
TTTTGTACGGAACCTCGGT -> TTTGTACGGAACCTCGGTC
TACTACGGATTGGAGAACC -> ACTACGGATTGGAGAACCA
GGATGTCCTTCTTGACCTG -> GATGTCCTTCTTGACCTGT
GTTGAGTTCCATTCCACTT -> TTGAGTTCCATTCCACTTC
AGTTGGCATGCGCCGAATC -> GTTGGCATGCGCCGAATCA
CTCCTATTGTCTCCACAGC -> TCCTATTGTCTCCACAGCA
GCTCGTATACTTTCAACAC -> CTCGTATACTTTCAACACC
AGCTCGTAGAACCACACCT -> GCTCGTAGAACCACACCTA
CTCTCGTCTGGTGACTTAT -> TCTCGTCTGGTGACTTATG
TCAAAACTCGCCGAAGACG -> CAAAACTCGCCGAAGACGC
GTCGACCAGATGGGATGCG -> TCGACCAGATGGGATGCGT
CTTGCCCACGTCCATCCAC -> TTGCCCACGTCCATCCACT
TTGCTTTCCCGAGTTTTTT -> TGCTTTCCCGAGTTTTTTG
TAGGTAGTACATCTCGCTT -> AGGTAGTACATCTCGCTTA
GCCGACCACCGTGGCTGCA -> CCGACCACCGTGGCTGCAC
CAACGATGGATTCCACCGA -> AACGATGGATTCCACCGAA
CGGACCCCCAACGATGGAT -> GGACCCCCAACGATGGATT
TATAGCCGCTTACCTAAAC -> ATAGCCGCTTACCTAAACC
CCTGTAACAAACCCTCTCC -> CTGTAACAAACCCTCTCCT
CACCCACTTTGCCTTGTGC -> ACCCACTTTGCCTTGTGCG
CTTCAGCAGCCAGCGAACG -> TTCAGCAGCCAGCGAACGA
ACCGGCAGGGTACCTCTCG -> CCGGCAGGGTACCTCTCGT
ATACCCTCGAATGCATTAC -> TACCCTCGAATGCATTACA
CACTTTGCCTTGTGCGTAT -> ACTTTGCCTTGTGCGTATC
GTCACTTAGCCCACCGGCA -> TCACTTAGCCCACCGGCAG
CGAGTTTTTTGTACGGAAC -> GAGTTTTTTGTACGGAACC
GGTCTGGGAGCGAAGCACT -> GTCTGGGAGCGAAGCACTG
CCTGTACTGGGTAACCCAT -> CTGTACTGGGTAACCCATA
GTACGGAACCTCGGTCTCT -> TACGGAACCTCGGTCTCTT
TTCCCGAGTTTTTTGTACG -> TCCCGAGTTTTTTGTACGG
CGATCAAAGTGCGTTCGGG -> GATCAAAGTGCGTTCGGGC
TAAGCTCACCCACGAAATC -> AAGCTCACCCACGAAATCC
CTGTCGACCAGATGGGATG -> TGTCGACCAGATGGGATGC
CTGTGGACAGGAATAGTGA -> TGTGGACAGGAATAGTGAC
GATTTTACCCTCCTAAGGT -> ATTTTACCCTCCTAAGGTC
CCGTCGGGAGTACATTTAA -> CGTCGGGAGTACATTTAAA
TACCAAGATAGCTCGTATA -> ACCAAGATAGCTCGTATAC
CGGCATTATAGGAATTTTG -> GGCATTATAGGAATTTTGT
ATTTGGAAGCCTTCGAGCT -> TTTGGAAGCCTTCGAGCTT
GAAGCCGCAGAGCCCGTTT -> AAGCCGCAGAGCCCGTTTG
AGGACATGTCCAAGCAGAA -> GGACATGTCCAAGCAGAAT
TTAAACAATAAGGGCCTTC -> TAAACAATAAGGGCCTTCA
CCTTCACGCGATCCGGTCT -> CTTCACGCGATCCGGTCTG
GACGCTACGAAGCTGATCG -> ACGCTACGAAGCTGATCGA
CCTTCGAGCTTCAAAGGAT -> CTTCGAGCTTCAAAGGATG
TCGGTCCATTCGAATGCTG -> CGGTCCATTCGAATGCTGC
ATGTTAGCACTTTAAATTA -> TGTTAGCACTTTAAATTAG
TGAACTCTATTACGATAGG -> GAACTCTATTACGATAGGT
AGATGGGATGCGTCACTTA -> GATGGGATGCGTCACTTAG
CGTGGCTGCACCTGTCGAC -> GTGGCTGCACCTGTCGACC
TGTAGAGCTACCTATATCC -> GTAGAGCTACCTATATCCG
CTAAACCAGAAAACAATAC -> TAAACCAGAAAACAATACT
CAAGGAGCCACTAGTCTGT -> AAGGAGCCACTAGTCTGTA,AAGGAGCCACTAGTCTGTA,AAGGAGCCACTAGTCTGTA
TATTGTCTCCACAGCAATT -> ATTGTCTCCACAGCAATTT
AATTAGGACACTCCTATTG -> ATTAGGACACTCCTATTGT
TGTATTTAAAGATCGTAGA -> GTATTTAAAGATCGTAGAG
ACACCTAATGCAGCCGCCG -> CACCTAATGCAGCCGCCGA
GCCTTGGACCACTTCCGTA -> CCTTGGACCACTTCCGTAC
ATTAATACCGGAACCTTAC -> TTAATACCGGAACCTTACA
TTATGCCGTACCGCGAGCG -> TATGCCGTACCGCGAGCGG
TCCGTCGGGAGTACATTTA -> CCGTCGGGAGTACATTTAA
TGCGCCGAATCAACTTCAG -> GCGCCGAATCAACTTCAGG
GATCGGCTTAAGTAATATA -> ATCGGCTTAAGTAATATAA
CTCAAACGGGCTCCAACTC -> TCAAACGGGCTCCAACTCC
ACGATAGGTAGTACATCTC -> CGATAGGTAGTACATCTCG
AATGCTGCACCCGATAGAG -> ATGCTGCACCCGATAGAGC
CGCTTACCTAAACCAGAAA -> GCTTACCTAAACCAGAAAA
GGGCTCCAACTCCGTACGA -> GGCTCCAACTCCGTACGAA
CATCAAGGAGCCACTAGTC -> ATCAAGGAGCCACTAGTCT
GGGTAACCCATAGAAATGT -> GGTAACCCATAGAAATGTT
TCCGACGTTATCGAAGCCG -> CCGACGTTATCGAAGCCGG
CTAATAACGGTAACCGTTC -> TAATAACGGTAACCGTTCG
GGTGTACATTTACCATCAA -> GTGTACATTTACCATCAAG
AGGCGCTTTGAACATGGCC -> GGCGCTTTGAACATGGCCT
TGCCGCTAGGATGTCCTTC -> GCCGCTAGGATGTCCTTCT
CTCCCAATGACTATGGCTA -> TCCCAATGACTATGGCTAA
CTTGGACCACTTCCGTACC -> TTGGACCACTTCCGTACCG
AATCTAATTAGCCCGGCTC -> ATCTAATTAGCCCGGCTCG
GAACTCTATTACGATAGGT -> AACTCTATTACGATAGGTA
CGAGCGGGTGACGGCTGCA -> GAGCGGGTGACGGCTGCAA
TCCTATTGTCTCCACAGCA -> CCTATTGTCTCCACAGCAA
GCGGGTGTACATTTACCAT -> CGGGTGTACATTTACCATC
TGCAACAATAATTCAGAGT -> GCAACAATAATTCAGAGTG
GGCGCTTTGAACATGGCCT -> GCGCTTTGAACATGGCCTT
TACTCCCCAAATTAATACC -> ACTCCCCAAATTAATACCG
AGAGTGCGAATACGCGCAA -> GAGTGCGAATACGCGCAAC
TCCACCGCCATTGTGATAG -> CCACCGCCATTGTGATAGC
AATGTTAAGGTCAGTCTTG -> ATGTTAAGGTCAGTCTTGA
GCTAATGCTTTCTTGCCCA -> CTAATGCTTTCTTGCCCAC
ATACTCCCCAAATTAATAC -> TACTCCCCAAATTAATACC
GTCCTAATGTAGACGCAGG -> TCCTAATGTAGACGCAGGA
CTGCTACAACAACTCCTGA -> TGCTACAACAACTCCTGAC
ACCAGGCGCTTTGAACATG -> CCAGGCGCTTTGAACATGG
AGGACACTCCTATTGTCTC -> GGACACTCCTATTGTCTCC
AACCAGGCGCTTTGAACAT -> ACCAGGCGCTTTGAACATG
CGAATACGCGCAACACGTT -> GAATACGCGCAACACGTTG
GCTTCAAAGGATGCTAAGA -> CTTCAAAGGATGCTAAGAT
ACTAGTCTGACCTCTTGAG -> CTAGTCTGACCTCTTGAGC
ACCCTCGAATGCATTACAG -> CCCTCGAATGCATTACAGA
CAGGGTCCTGTGGACAGGA -> AGGGTCCTGTGGACAGGAA
TGGACCACTTCCGTACCGC -> GGACCACTTCCGTACCGCG
GACTTATGCCGTACCGCGA -> ACTTATGCCGTACCGCGAG
ATTTTGTTTGCCCCACGTA -> TTTTGTTTGCCCCACGTAA
TTCGGGCCTCCCAATGACT -> TCGGGCCTCCCAATGACTA
AGCCGCCGACCACCGTGGC -> GCCGCCGACCACCGTGGCT
GTGCACCTGTAATTATGAC -> TGCACCTGTAATTATGACC
GGCTAATGCTTTCTTGCCC -> GCTAATGCTTTCTTGCCCA
GTAGAGCTACCTATATCCG -> TAGAGCTACCTATATCCGC
TACTTTCAACACCGTACCG -> ACTTTCAACACCGTACCGC
GGGCCTTCAGCAGCCAGCG -> GGCCTTCAGCAGCCAGCGA
CGGGTGTACATTTACCATC -> GGGTGTACATTTACCATCA
TGCATTACAGAGCTCGTAG -> GCATTACAGAGCTCGTAGA
ACGGGACGCTACGAAGCTG -> CGGGACGCTACGAAGCTGA
TAGAGCCACAAACAAACGG -> AGAGCCACAAACAAACGGG
CCGATACCCTCGAATGCAT -> CGATACCCTCGAATGCATT
TCGGATATACGGTTGGCAC -> CGGATATACGGTTGGCACG
CGGCCGATCCGGACGAGTT -> GGCCGATCCGGACGAGTTG
GTTTCTACCGAACAGATTT -> TTTCTACCGAACAGATTTC
AACGGGACGCTACGAAGCT -> ACGGGACGCTACGAAGCTG
CAGCAGAACGCCCGGTCGG -> AGCAGAACGCCCGGTCGGA
TTTGACGACCGAACTGACT -> TTGACGACCGAACTGACTA
AACCAGAAAACAATACTAC -> ACCAGAAAACAATACTACG
TGGTGACTTATGCCGTACC -> GGTGACTTATGCCGTACCG
CCGCCATTGTGATAGCTAA -> CGCCATTGTGATAGCTAAT
TGCGTTCGGGCCTCCCAAT -> GCGTTCGGGCCTCCCAATG
TTTTTGTACGGAACCTCGG -> TTTTGTACGGAACCTCGGT
CCGAACTGACTACACATTT -> CGAACTGACTACACATTTC
TCCACCGAACCCGTACCGC -> CCACCGAACCCGTACCGCG
GTTGGCATGCGCCGAATCA -> TTGGCATGCGCCGAATCAA
CGTCCATCCACTTGCTACC -> GTCCATCCACTTGCTACCA
TCCGGACGAGTTGGCATGC -> CCGGACGAGTTGGCATGCG
CGAAGCCGGGATTTAATAG -> GAAGCCGGGATTTAATAGC
AGTACATTTAAACAATAAG -> GTACATTTAAACAATAAGG
CCATAGAAATGTTAAGGTC -> CATAGAAATGTTAAGGTCA
GCCGCATCTGCCCAGTGCA -> CCGCATCTGCCCAGTGCAA
TGTGCGTATCCTAACTTTA -> GTGCGTATCCTAACTTTAT
ACACCGTACCGCGAGCGGG -> CACCGTACCGCGAGCGGGT
ATGGAATTAGGACACTCCT -> TGGAATTAGGACACTCCTA
CCCACGTCCATCCACTTGC -> CCACGTCCATCCACTTGCT
GCCACAAACAAACGGGACG -> CCACAAACAAACGGGACGC
ATCATATGCGATCAAAGTG -> TCATATGCGATCAAAGTGC
GGACTTTATATCGACTGAT -> GACTTTATATCGACTGATG
GGCTGCAATTCAAGGAGCC -> GCTGCAATTCAAGGAGCCA
CAACTTCAGGGACTTTATA -> AACTTCAGGGACTTTATAT
ACCTTACAGTTATCCGACG -> CCTTACAGTTATCCGACGT
ATTTTACCCTCCTAAGGTC -> TTTTACCCTCCTAAGGTCA
GCGATGAATCCTGTAACAA -> CGATGAATCCTGTAACAAA
GCCCGGCTCGCGTGTGCAC -> CCCGGCTCGCGTGTGCACC
AAGGAGCCACTAGTCTGTA -> AGGAGCCACTAGTCTGTAA,AGGAGCCACTAGTCTGTAT,AGGAGCCACTAGTCTGTAT
GCTTTGGTTTGTGGCGAAT -> CTTTGGTTTGTGGCGAATC
TGATGTAGGGCTACGAGAG -> GATGTAGGGCTACGAGAGG
GTGCAACGTATCATTCAAG -> TGCAACGTATCATTCAAGG
AATACGCGCAACACGTTGC -> ATACGCGCAACACGTTGCT
CCGGCAGGGTACCTCTCGT -> CGGCAGGGTACCTCTCGTC
CCAGATGGGATGCGTCACT -> CAGATGGGATGCGTCACTT
CGGATATACGGTTGGCACG -> GGATATACGGTTGGCACGG
CCATCAAGGAGCCACTAGT -> CATCAAGGAGCCACTAGTC
TAGTGACGCTGATCACACC -> AGTGACGCTGATCACACCA
ATAGATCGGCTTAAGTAAT -> TAGATCGGCTTAAGTAATA
CGCAGGGTCCTGTGGACAG -> GCAGGGTCCTGTGGACAGG
AGAGGGCGCCCCAACGTTC -> GAGGGCGCCCCAACGTTCG
GATGATACCGCATGCATCT -> ATGATACCGCATGCATCTT
TCGTATACTTTCAACACCG -> CGTATACTTTCAACACCGT
TTATGACTAATTTGAATAC -> TATGACTAATTTGAATACT
ATATAAGTGCCCATTTGTA -> TATAAGTGCCCATTTGTAT
TCGTAGAACCACACCTAAT -> CGTAGAACCACACCTAATG
TGGAGTATAGCCGCTTACC -> GGAGTATAGCCGCTTACCT
GGGAGCGAAGCACTGACGA -> GGAGCGAAGCACTGACGAC
TATCCGCGGCCGATCCGGA -> ATCCGCGGCCGATCCGGAC
AGTGCATTGGATTACGGCA -> GTGCATTGGATTACGGCAT
AACGATGGATTCCACCGAA -> ACGATGGATTCCACCGAAC
TACAGTTATCCGACGTTAT -> ACAGTTATCCGACGTTATC
ACCATAGATCGGCTTAAGT -> CCATAGATCGGCTTAAGTA
ATACGGTTGGCACGGTCAT -> TACGGTTGGCACGGTCATG
TAGTCTGACCTCTTGAGCA -> AGTCTGACCTCTTGAGCAC
GTCTGGTGACTTATGCCGT -> TCTGGTGACTTATGCCGTA
CTGACTACACATTTCTGAA -> TGACTACACATTTCTGAAC
GACAGTCCTAATGTAGACG -> ACAGTCCTAATGTAGACGC
ATCCGCGGCCGATCCGGAC -> TCCGCGGCCGATCCGGACG
TTCGATTGCGCAGAGGGCG -> TCGATTGCGCAGAGGGCGC
CCGCGGCCGATCCGGACGA -> CGCGGCCGATCCGGACGAG
GATGCGTCACTTAGCCCAC -> ATGCGTCACTTAGCCCACC
TAGTACATCTCGCTTAGCG -> AGTACATCTCGCTTAGCGA
GCCCGTTTGCCTGGATTTT -> CCCGTTTGCCTGGATTTTA
ATATTATGGAATTAGGACA -> TATTATGGAATTAGGACAC
TTACCTAAACCAGAAAACA -> TACCTAAACCAGAAAACAA
CTAGTCTGTATATCCGTCG -> TAGTCTGTATATCCGTCGG
CTTAAGTAATATAAGTGCC -> TTAAGTAATATAAGTGCCC
TTAGGGACCCGTTGAGTTC -> TAGGGACCCGTTGAGTTCC
ACAATACTACGGATTGGAG -> CAATACTACGGATTGGAGA
ATTGCTTTGGTTTGTGGCG -> TTGCTTTGGTTTGTGGCGA
AGCCTTCGAGCTTCAAAGG -> GCCTTCGAGCTTCAAAGGA
TTTAAATTAGCAGTGCATT -> TTAAATTAGCAGTGCATTG
CCAGTGCAACAATAATTCA -> CAGTGCAACAATAATTCAG
GTTATCCGACGTTATCGAA -> TTATCCGACGTTATCGAAG
GAATACTCCCCAAATTAAT -> AATACTCCCCAAATTAATA
ATGACCTAATCTGCCGTCG -> TGACCTAATCTGCCGTCGT
TGCCTGGATTTTACCCTCC -> GCCTGGATTTTACCCTCCT
TGGACAGGAATAGTGACGC -> GGACAGGAATAGTGACGCT
TCAACTCCGTGGCGTGAAC -> CAACTCCGTGGCGTGAACT
GCTGCACCTGTCGACCAGA -> CTGCACCTGTCGACCAGAT
TAATCTGACCAATCTAATT -> AATCTGACCAATCTAATTA
ATGGAGTTATATTATGGAA -> TGGAGTTATATTATGGAAT
GTAGAGGGTAGTATAGCCC -> TAGAGGGTAGTATAGCCCT
GGGATGCGTCACTTAGCCC -> GGATGCGTCACTTAGCCCA
ATGGAGTATAGCCGCTTAC -> TGGAGTATAGCCGCTTACC
TCACTGCTACAACAACTCC -> CACTGCTACAACAACTCCT
TAAGGTCATAGCCGTTGCT -> AAGGTCATAGCCGTTGCTT
GCCCGGTCGGATATACGGT -> CCCGGTCGGATATACGGTT
CGCGAGCGGGTGCAACGTA -> GCGAGCGGGTGCAACGTAT
TTACGATAGGTAGTACATC -> TACGATAGGTAGTACATCT
AGTAGAAGCCGCAGAGCCC -> GTAGAAGCCGCAGAGCCCG
CCCAGTGCAACAATAATTC -> CCAGTGCAACAATAATTCA
GCCCCACGTAACCTTGGTA -> CCCCACGTAACCTTGGTAA
GCACCCGATAGAGCCACAA -> CACCCGATAGAGCCACAAA
AATTAGCCCGGCTCGCGTG -> ATTAGCCCGGCTCGCGTGT
GTGATAGCTAATAACGGTA -> TGATAGCTAATAACGGTAA
TAGTCTGTATATCCGTCGG -> AGTCTGTATATCCGTCGGG
GCTGCACCCGATAGAGCCA -> CTGCACCCGATAGAGCCAC
ATAATTCAGAGTGCGAATA -> TAATTCAGAGTGCGAATAC
GAGCGCGGGTATCAAGGAG -> AGCGCGGGTATCAAGGAGC
CTACCAAGATAGCTCGTAT -> TACCAAGATAGCTCGTATA
CCGGCTCGCGTGTGCACCT -> CGGCTCGCGTGTGCACCTG
GTATACTTTCAACACCGTA -> TATACTTTCAACACCGTAC
TACGGATTGGAGAACCAGG -> ACGGATTGGAGAACCAGGC
CACCCGATAGAGCCACAAA -> ACCCGATAGAGCCACAAAC
AACTTCAGGGACTTTATAT -> ACTTCAGGGACTTTATATC
GGTTGGCACGGTCATGGGA -> GTTGGCACGGTCATGGGAC
TCATGGGACAGTCCTAATG -> CATGGGACAGTCCTAATGT
ATTACAGAGCTCGTAGAAC -> TTACAGAGCTCGTAGAACC
AGCCCGTTTGCCTGGATTT -> GCCCGTTTGCCTGGATTTT
CATGGCCTTCAGCAGAACG -> ATGGCCTTCAGCAGAACGC
ACTCCGTGGCGTGAACTCT -> CTCCGTGGCGTGAACTCTA
CGCGGGTATCAAGGAGCCA -> GCGGGTATCAAGGAGCCAC
GACTATGGCTAATGCTTTC -> ACTATGGCTAATGCTTTCT
TGCCTTGTGCGTATCCTAA -> GCCTTGTGCGTATCCTAAC
TCCACTTGCTACCATAGTT -> CCACTTGCTACCATAGTTT
GCTGATGTAGGGCTACGAG -> CTGATGTAGGGCTACGAGA
CCAGTTGTTTATGTTTTCC -> CAGTTGTTTATGTTTTCCT
GACGTTATCGAAGCCGGGA -> ACGTTATCGAAGCCGGGAT
CCACCGAACCCGTACCGCG -> CACCGAACCCGTACCGCGA
TTCCGTACCGCGAGCGGGT -> TCCGTACCGCGAGCGGGTG
TCTTTATGTTAGCACTTTA -> CTTTATGTTAGCACTTTAA
CAGGTGCTAGTTATGACTA -> AGGTGCTAGTTATGACTAA
AGAGCCCGTTTGCCTGGAT -> GAGCCCGTTTGCCTGGATT
GCGGACCCCCAACGATGGA -> CGGACCCCCAACGATGGAT
GATACCGCATGCATCTTTT -> ATACCGCATGCATCTTTTA
CGAGTTGGCATGCGCCGAA -> GAGTTGGCATGCGCCGAAT
CCGGACGAGTTGGCATGCG -> CGGACGAGTTGGCATGCGC
GAACGAAACCACGATGGAG -> AACGAAACCACGATGGAGT
CAAGGAGCCACTAGTCTGA -> AAGGAGCCACTAGTCTGAC
CATTTGTATTTAAAGATCG -> ATTTGTATTTAAAGATCGT
CACCGAACCCGTACCGCGA -> ACCGAACCCGTACCGCGAG
TAATACCGGAACCTTACAG -> AATACCGGAACCTTACAGT
TGTTTGCCCCACGTAACCT -> GTTTGCCCCACGTAACCTT
CAACTCCGTACGAATCACT -> AACTCCGTACGAATCACTG
CGGGTGCAACGTATCATTC -> GGGTGCAACGTATCATTCA
TATCCTAACTTTATCATAT -> ATCCTAACTTTATCATATG
CTTGGTAAGTGTACCAGTT -> TTGGTAAGTGTACCAGTTG
GAGAGGACATGTCCAAGCA -> AGAGGACATGTCCAAGCAG
AAGATAGCTCGTATACTTT -> AGATAGCTCGTATACTTTC
AAGTGCGTTCGGGCCTCCC -> AGTGCGTTCGGGCCTCCCA
CGAAGCTGATCGAGAGGAC -> GAAGCTGATCGAGAGGACA
CGGTCGGATATACGGTTGG -> GGTCGGATATACGGTTGGC
TAAGTGCCCATTTGTATTT -> AAGTGCCCATTTGTATTTA
ATTACGGCATTATAGGAAT -> TTACGGCATTATAGGAATT
ATTCCACTTCGCCTTCGTT -> TTCCACTTCGCCTTCGTTT
AGCTCGTATACTTTCAACA -> GCTCGTATACTTTCAACAC
TACTGGGTAACCCATAGAA -> ACTGGGTAACCCATAGAAA
CGCCGCATCTGCCCAGTGC -> GCCGCATCTGCCCAGTGCA
AGTGCAACAATAATTCAGA -> GTGCAACAATAATTCAGAG
CAAATTAATACCGGAACCT -> AAATTAATACCGGAACCTT
TTGGCACGGTCATGGGACA -> TGGCACGGTCATGGGACAG
CTGTATATCCGTCGGGAGT -> TGTATATCCGTCGGGAGTA
CGGATTGGAGAACCAGGCG -> GGATTGGAGAACCAGGCGC
GAGTACATTTAAACAATAA -> AGTACATTTAAACAATAAG
CACAAACAAACGGGACGCT -> ACAAACAAACGGGACGCTA
TACCGCGAGCGGGTGACGG -> ACCGCGAGCGGGTGACGGC
GGGTGCAACGTATCATTCA -> GGTGCAACGTATCATTCAA
CCTAATTCTGGGCTAAGCC -> CTAATTCTGGGCTAAGCCT
GATGTCCTTCTTGACCTGT -> ATGTCCTTCTTGACCTGTA
GAATTCGATTGCGCAGAGG -> AATTCGATTGCGCAGAGGG
CATTATAGGAATTTTGTTT -> ATTATAGGAATTTTGTTTG
TTGTATTTAAAGATCGTAG -> TGTATTTAAAGATCGTAGA
TTGAGATGATACCGCATGC -> TGAGATGATACCGCATGCA
CGAGCGGGTGTACATTTAC -> GAGCGGGTGTACATTTACC
AGAAAACAATACTACGGAT -> GAAAACAATACTACGGATT
ACCGCATGCATCTTTTAAG -> CCGCATGCATCTTTTAAGG
TGGATTTTACCCTCCTAAG -> GGATTTTACCCTCCTAAGG
TAAACCAGAAAACAATACT -> AAACCAGAAAACAATACTA
CGGTCCATTCGAATGCTGC -> GGTCCATTCGAATGCTGCA
CGTCGGGAGTACATTTAAA -> GTCGGGAGTACATTTAAAC
CTGCAATTCAAGGAGCCAC -> TGCAATTCAAGGAGCCACT
TAATATAAGTGCCCATTTG -> AATATAAGTGCCCATTTGT
GTCCAAGCAGAATTGCTCA -> TCCAAGCAGAATTGCTCAA
TCCATCCACTTGCTACCAT -> CCATCCACTTGCTACCATA
TTTTGTTTGCCCCACGTAA -> TTTGTTTGCCCCACGTAAC
CCGCGAGCGGGTGCAACGT -> CGCGAGCGGGTGCAACGTA
CCAAGATAGCTCGTATACT -> CAAGATAGCTCGTATACTT
CGACCACCGTGGCTGCACC -> GACCACCGTGGCTGCACCT
TTCAGCAGAACGCCCGGTC -> TCAGCAGAACGCCCGGTCG
CACTTTAAATTAGCAGTGC -> ACTTTAAATTAGCAGTGCA
CGTTGCTGTACTAGGAGTA -> GTTGCTGTACTAGGAGTAC
GCGCCTCGATCAAAACTCG -> CGCCTCGATCAAAACTCGC
CCCGTTGAGTTCCATTCCA -> CCGTTGAGTTCCATTCCAC
CCTGTCGACCAGATGGGAT -> CTGTCGACCAGATGGGATG
TCCCAATGACTATGGCTAA -> CCCAATGACTATGGCTAAT
AATAGCAAGGGATCGTAGA -> ATAGCAAGGGATCGTAGAC
GAGGGTTAATCTCGACAAA -> AGGGTTAATCTCGACAAAT
GGAGCGAAGCACTGACGAC -> GAGCGAAGCACTGACGACG
ACTAGTCTGTATATCCGTC -> CTAGTCTGTATATCCGTCG
TAGCACTTTAAATTAGCAG -> AGCACTTTAAATTAGCAGT
AGTTTGACGACCGAACTGA -> GTTTGACGACCGAACTGAC
GCGCCGAATCAACTTCAGG -> CGCCGAATCAACTTCAGGG
CGATCAAAACTCGCCGAAG -> GATCAAAACTCGCCGAAGA
TTTAGCTGATGTAGGGCTA -> TTAGCTGATGTAGGGCTAC
CACCCACGAAATCCACCGC -> ACCCACGAAATCCACCGCC
ACCCACGAAATCCACCGCC -> CCCACGAAATCCACCGCCA
TGCGATCAAAGTGCGTTCG -> GCGATCAAAGTGCGTTCGG
CGAAATCCACCGCCATTGT -> GAAATCCACCGCCATTGTG
GAGCTCGTAGAACCACACC -> AGCTCGTAGAACCACACCT
TCTGCCGTCGTCCGATACC -> CTGCCGTCGTCCGATACCC
CAGCCGCCGACCACCGTGG -> AGCCGCCGACCACCGTGGC
ATCACTGCTACAACAACTC -> TCACTGCTACAACAACTCC
GCCCACCGGCAGGGTACCT -> CCCACCGGCAGGGTACCTC
GGAGCCACTAGTCTGTAAC -> GAGCCACTAGTCTGTAACG
CCCACGTAACCTTGGTAAG -> CCACGTAACCTTGGTAAGT
AGTGCGAATACGCGCAACA -> GTGCGAATACGCGCAACAC
GCCATTGTGATAGCTAATA -> CCATTGTGATAGCTAATAA
CGAATCACTGCTACAACAA -> GAATCACTGCTACAACAAC
ACCGCGAGCGGGTGTACAT -> CCGCGAGCGGGTGTACATT
CAAAGTGCGTTCGGGCCTC -> AAAGTGCGTTCGGGCCTCC
TTAAATTAGCAGTGCATTG -> TAAATTAGCAGTGCATTGG
AGATTTCCTTTAGCTGATG -> GATTTCCTTTAGCTGATGT
TGCTCAAACGGGCTCCAAC -> GCTCAAACGGGCTCCAACT
AGCCGTTGCTTTCCCGAGT -> GCCGTTGCTTTCCCGAGTT
CCCAACGTTCGGGCGGTCG -> CCAACGTTCGGGCGGTCGG
CCCACGAAATCCACCGCCA -> CCACGAAATCCACCGCCAT
GACGCTGATCACACCACCC -> ACGCTGATCACACCACCCA
AATAATTCAGAGTGCGAAT -> ATAATTCAGAGTGCGAATA
ATGTCCAAGCAGAATTGCT -> TGTCCAAGCAGAATTGCTC
CCATTGTGATAGCTAATAA -> CATTGTGATAGCTAATAAC
AGGAATTTTGTTTGCCCCA -> GGAATTTTGTTTGCCCCAC
AGCCGGGATTTAATAGCAA -> GCCGGGATTTAATAGCAAG
GACCTAATCTGCCGTCGTC -> ACCTAATCTGCCGTCGTCC
GTAGTACATCTCGCTTAGC -> TAGTACATCTCGCTTAGCG
GCAGAACGCCCGGTCGGAT -> CAGAACGCCCGGTCGGATA
CGTTTGCCTGGATTTTACC -> GTTTGCCTGGATTTTACCC
GTTGGCACGGTCATGGGAC -> TTGGCACGGTCATGGGACA
CCACGTAACCTTGGTAAGT -> CACGTAACCTTGGTAAGTG
TGACTACACATTTCTGAAC -> GACTACACATTTCTGAACT
CAGCGAACGAAACCACGAT -> AGCGAACGAAACCACGATG
GCAGGGTCCTGTGGACAGG -> CAGGGTCCTGTGGACAGGA
CCTAATGCAGCCGCCGACC -> CTAATGCAGCCGCCGACCA
ATCAAGGAGCCACTAGTCT -> TCAAGGAGCCACTAGTCTG,TCAAGGAGCCACTAGTCTG
AGTTATATTATGGAATTAG -> GTTATATTATGGAATTAGG
TCAACTTCAGGGACTTTAT -> CAACTTCAGGGACTTTATA
CATTTACCATCAAGGAGCC -> ATTTACCATCAAGGAGCCA
TCAGGGACTTTATATCGAC -> CAGGGACTTTATATCGACT
GTCCATCCACTTGCTACCA -> TCCATCCACTTGCTACCAT
GGTATCAAGGAGCCACTAG -> GTATCAAGGAGCCACTAGT
CTAATCTGACCAATCTAAT -> TAATCTGACCAATCTAATT
ACCTGTCGACCAGATGGGA -> CCTGTCGACCAGATGGGAT
GCGTTCGGGCCTCCCAATG -> CGTTCGGGCCTCCCAATGA
GCTAGTTATGACTAATTTG -> CTAGTTATGACTAATTTGA
GGATCGTAGACCACCTAAT -> GATCGTAGACCACCTAATT
TAAGTGTACCAGTTGTTTA -> AAGTGTACCAGTTGTTTAT
TGCACCTGTCGACCAGATG -> GCACCTGTCGACCAGATGG
CTTCGCCTTCGTTTCTACC -> TTCGCCTTCGTTTCTACCG
TTGGTAAGTGTACCAGTTG -> TGGTAAGTGTACCAGTTGT
GAGGGCGCCCCAACGTTCG -> AGGGCGCCCCAACGTTCGG
CCACCCACTTTGCCTTGTG -> CACCCACTTTGCCTTGTGC
AGGGCGCCCCAACGTTCGG -> GGGCGCCCCAACGTTCGGG
AAGGCGCCTCGATCAAAAC -> AGGCGCCTCGATCAAAACT
TCGTCTGGTGACTTATGCC -> CGTCTGGTGACTTATGCCG
TCCGTGGCGTGAACTCTAT -> CCGTGGCGTGAACTCTATT
AACCCTCTCCTCCTGTACT -> ACCCTCTCCTCCTGTACTG
ACTCGCCGAAGACGCTATT -> CTCGCCGAAGACGCTATTC
ACCACCGTGGCTGCACCTG -> CCACCGTGGCTGCACCTGT
CGTACCGCGAGCGGGTGAC -> GTACCGCGAGCGGGTGACG
TAGAGCTACCTATATCCGC -> AGAGCTACCTATATCCGCG
ACCCGTTGAGTTCCATTCC -> CCCGTTGAGTTCCATTCCA
AGGTCATAGCCGTTGCTTT -> GGTCATAGCCGTTGCTTTC
TAACGGTAACCGTTCGTTG -> AACGGTAACCGTTCGTTGT
TCAAAGGATGCTAAGATAA -> CAAAGGATGCTAAGATAAG
TTGCCCACGTCCATCCACT -> TGCCCACGTCCATCCACTT
CTAATTAGCCCGGCTCGCG -> TAATTAGCCCGGCTCGCGT
TTTATATCGACTGATGAGG -> TTATATCGACTGATGAGGG
TTAAAGATCGTAGAGGGTA -> TAAAGATCGTAGAGGGTAG
CATTTCTGAACTGCCGCTA -> ATTTCTGAACTGCCGCTAG
TTAAGGTCAGTCTTGAGAT -> TAAGGTCAGTCTTGAGATG
GTGCGTTCGGGCCTCCCAA -> TGCGTTCGGGCCTCCCAAT
CGAGAGGACATGTCCAAGC -> GAGAGGACATGTCCAAGCA
CCACTAGTCTGTAACGGTC -> CACTAGTCTGTAACGGTCC
CACGTCCATCCACTTGCTA -> ACGTCCATCCACTTGCTAC
GTTATATTATGGAATTAGG -> TTATATTATGGAATTAGGA
AGCCACTAGTCTGTAACGG -> GCCACTAGTCTGTAACGGT
TAATCTCGACAAATTTGTG -> AATCTCGACAAATTTGTGT
GTAGAACCACACCTAATGC -> TAGAACCACACCTAATGCA
ACGCTGATCACACCACCCA -> CGCTGATCACACCACCCAC
AACAAACCCTCTCCTCCTG -> ACAAACCCTCTCCTCCTGT
CGGTCGGTCCATTCGAATG -> GGTCGGTCCATTCGAATGC
TCCGTACCGCGAGCGGGTG -> CCGTACCGCGAGCGGGTGT
GCCGAATCAACTTCAGGGA -> CCGAATCAACTTCAGGGAC
AGTACCTTCACGCGATCCG -> GTACCTTCACGCGATCCGG
GTCTTGAGATGATACCGCA -> TCTTGAGATGATACCGCAT
CGTAGAACCACACCTAATG -> GTAGAACCACACCTAATGC
CTACCATAGTTTAGGGACC -> TACCATAGTTTAGGGACCC
TGCTAAGATAAGCTCACCC -> GCTAAGATAAGCTCACCCA
TAGCCCGGCTCGCGTGTGC -> AGCCCGGCTCGCGTGTGCA
CGTATCCTAACTTTATCAT -> GTATCCTAACTTTATCATA
CCACGAAATCCACCGCCAT -> CACGAAATCCACCGCCATT
CAGCAATTTGGAAGCCTTC -> AGCAATTTGGAAGCCTTCG
GCGAGCGGGTGTACATTTA -> CGAGCGGGTGTACATTTAC
AAGCCTTCGAGCTTCAAAG -> AGCCTTCGAGCTTCAAAGG
AATTAATACCGGAACCTTA -> ATTAATACCGGAACCTTAC
CCCAATGACTATGGCTAAT -> CCAATGACTATGGCTAATG
GGCCTCCCAATGACTATGG -> GCCTCCCAATGACTATGGC
TAGCTCGTATACTTTCAAC -> AGCTCGTATACTTTCAACA
CGCAGAGCCCGTTTGCCTG -> GCAGAGCCCGTTTGCCTGG
CGAGCGGGTGGAGCGCGGG -> GAGCGGGTGGAGCGCGGGT
ATGCTGCACCCGATAGAGC -> TGCTGCACCCGATAGAGCC
GATATACGGTTGGCACGGT -> ATATACGGTTGGCACGGTC
CGAACCCGTACCGCGAGCG -> GAACCCGTACCGCGAGCGG
CCGAAGACGCTATTCAATC -> CGAAGACGCTATTCAATCT
AAGGGCCTTCAGCAGCCAG -> AGGGCCTTCAGCAGCCAGC
TGGGATGCGTCACTTAGCC -> GGGATGCGTCACTTAGCCC
CTTTGCCTTGTGCGTATCC -> TTTGCCTTGTGCGTATCCT
CCGTACCGCGAGCGGGTGC -> CGTACCGCGAGCGGGTGCA
TGCCCAGTGCAACAATAAT -> GCCCAGTGCAACAATAATT
GCCGAAGACGCTATTCAAT -> CCGAAGACGCTATTCAATC
CTTTATCATATGCGATCAA -> TTTATCATATGCGATCAAA
TCTATTACGATAGGTAGTA -> CTATTACGATAGGTAGTAC
ACTACACATTTCTGAACTG -> CTACACATTTCTGAACTGC
TTTGTGGCGAATCGCTGGC -> TTGTGGCGAATCGCTGGCG
GTCCTGTGGACAGGAATAG -> TCCTGTGGACAGGAATAGT
GCTCAAACGGGCTCCAACT -> CTCAAACGGGCTCCAACTC
CGAATGCTGCACCCGATAG -> GAATGCTGCACCCGATAGA
TGTTAAGGTCAGTCTTGAG -> GTTAAGGTCAGTCTTGAGA
CTCGTAGAACCACACCTAA -> TCGTAGAACCACACCTAAT
GCCGCCGACCACCGTGGCT -> CCGCCGACCACCGTGGCTG
TCGCCGAAGACGCTATTCA -> CGCCGAAGACGCTATTCAA
GGACGCTACGAAGCTGATC -> GACGCTACGAAGCTGATCG
AATGCATTACAGAGCTCGT -> ATGCATTACAGAGCTCGTA
AAGACGCTATTCAATCTTG -> AGACGCTATTCAATCTTGA
AGATAGCTCGTATACTTTC -> GATAGCTCGTATACTTTCA
TCCTTTAGCTGATGTAGGG -> CCTTTAGCTGATGTAGGGC
ATCTCAGTCGAATTCGATT -> TCTCAGTCGAATTCGATTG
ACGAATCACTGCTACAACA -> CGAATCACTGCTACAACAA
AGGATGCTAAGATAAGCTC -> GGATGCTAAGATAAGCTCA
GGTGACGGCTGCAATTCAA -> GTGACGGCTGCAATTCAAG
ATGTAGACGCAGGACGTAG -> TGTAGACGCAGGACGTAGT
GCGAGCGGGTGGAGCGCGG -> CGAGCGGGTGGAGCGCGGG
ACGCGATCCGGTCTGGGAG -> CGCGATCCGGTCTGGGAGC
GTGCGAATACGCGCAACAC -> TGCGAATACGCGCAACACG
TCAACACCGTACCGCGAGC -> CAACACCGTACCGCGAGCG
GTAGACCACCTAATTCTGG -> TAGACCACCTAATTCTGGG
CCGCATCTGCCCAGTGCAA -> CGCATCTGCCCAGTGCAAC
CTATATCCGCGGCCGATCC -> TATATCCGCGGCCGATCCG
TTGCTACCATAGTTTAGGG -> TGCTACCATAGTTTAGGGA
GCTAAGATAAGCTCACCCA -> CTAAGATAAGCTCACCCAC
ACGTTGCTGTACTAGGAGT -> CGTTGCTGTACTAGGAGTA
CGCTGATCACACCACCCAC -> GCTGATCACACCACCCACT
TGCAGCCGCCGACCACCGT -> GCAGCCGCCGACCACCGTG
CCTGTAGAGCTACCTATAT -> CTGTAGAGCTACCTATATC
TTTCTTGCCCACGTCCATC -> TTCTTGCCCACGTCCATCC
ACGTAGTTTGACGACCGAA -> CGTAGTTTGACGACCGAAC
TAGTTATGACTAATTTGAA -> AGTTATGACTAATTTGAAT
AAAACAATACTACGGATTG -> AAACAATACTACGGATTGG
CTGTAACAAACCCTCTCCT -> TGTAACAAACCCTCTCCTC
CGCGAGCGGGTGACGGCTG -> GCGAGCGGGTGACGGCTGC
TCGTCCGATACCCTCGAAT -> CGTCCGATACCCTCGAATG
TTGTGTACCATAGATCGGC -> TGTGTACCATAGATCGGCT
TCTGCCCAGTGCAACAATA -> CTGCCCAGTGCAACAATAA
GACTACACATTTCTGAACT -> ACTACACATTTCTGAACTG
CGTACCGCGAGCGGGTGTA -> GTACCGCGAGCGGGTGTAC
TCAGTCGAATTCGATTGCG -> CAGTCGAATTCGATTGCGC
TGAACATGGCCTTCAGCAG -> GAACATGGCCTTCAGCAGA
GATTACGGCATTATAGGAA -> ATTACGGCATTATAGGAAT
GCACGCAGGGTCCTGTGGA -> CACGCAGGGTCCTGTGGAC
CACGTAACCTTGGTAAGTG -> ACGTAACCTTGGTAAGTGT
TTTGTTTGCCCCACGTAAC -> TTGTTTGCCCCACGTAACC
AACTCCGTGGCGTGAACTC -> ACTCCGTGGCGTGAACTCT
GACGCAGGAGTACCTTCAC -> ACGCAGGAGTACCTTCACG
GAATACGCGCAACACGTTG -> AATACGCGCAACACGTTGC
CCTAATGTAGACGCAGGAC -> CTAATGTAGACGCAGGACG
TTCCACCGAACCCGTACCG -> TCCACCGAACCCGTACCGC
TTTGCCTGGATTTTACCCT -> TTGCCTGGATTTTACCCTC
CAGCAGCCAGCGAACGAAA -> AGCAGCCAGCGAACGAAAC
TCCTAACTTTATCATATGC -> CCTAACTTTATCATATGCG
CTAGTCTGACCTCTTGAGC -> TAGTCTGACCTCTTGAGCA
AGAGGACATGTCCAAGCAG -> GAGGACATGTCCAAGCAGA
CACTAGTCTGTATTGCTTT -> ACTAGTCTGTATTGCTTTG
TACACATTTCTGAACTGCC -> ACACATTTCTGAACTGCCG
CTATGGCTAATGCTTTCTT -> TATGGCTAATGCTTTCTTG
ACGAAACCACGATGGAGTA -> CGAAACCACGATGGAGTAA
GATGAGGGTTAATCTCGAC -> ATGAGGGTTAATCTCGACA
CGGTCATGGGACAGTCCTA -> GGTCATGGGACAGTCCTAA
TAATGCAGCCGCCGACCAC -> AATGCAGCCGCCGACCACC
TGCTAGTTATGACTAATTT -> GCTAGTTATGACTAATTTG
TGTCGACCAGATGGGATGC -> GTCGACCAGATGGGATGCG
TGTCCAAGCAGAATTGCTC -> GTCCAAGCAGAATTGCTCA
GGCGTGAACTCTATTACGA -> GCGTGAACTCTATTACGAT
CAGATTTCCTTTAGCTGAT -> AGATTTCCTTTAGCTGATG
TACCATAGTTTAGGGACCC -> ACCATAGTTTAGGGACCCG
TGGCGGACCCCCAACGATG -> GGCGGACCCCCAACGATGG
GGACATGTCCAAGCAGAAT -> GACATGTCCAAGCAGAATT
ATACGCGCAACACGTTGCT -> TACGCGCAACACGTTGCTG
GAGAACCAGGCGCTTTGAA -> AGAACCAGGCGCTTTGAAC
GTGACTTATGCCGTACCGC -> TGACTTATGCCGTACCGCG
GCCTTCAGCAGAACGCCCG -> CCTTCAGCAGAACGCCCGG
CGGGAGTACATTTAAACAA -> GGGAGTACATTTAAACAAT
ACAGCAATTTGGAAGCCTT -> CAGCAATTTGGAAGCCTTC
AGCGAAGCACTGACGACGT -> GCGAAGCACTGACGACGTA
TCGAGCTTCAAAGGATGCT -> CGAGCTTCAAAGGATGCTA
CCGAACCCGTACCGCGAGC -> CGAACCCGTACCGCGAGCG
CTGTACTGGGTAACCCATA -> TGTACTGGGTAACCCATAG
ATGGCTAATGCTTTCTTGC -> TGGCTAATGCTTTCTTGCC
AGAACCACACCTAATGCAG -> GAACCACACCTAATGCAGC
GAGTACCTTCACGCGATCC -> AGTACCTTCACGCGATCCG
TTTCAACACCGTACCGCGA -> TTCAACACCGTACCGCGAG
GGTCGGTCCATTCGAATGC -> GTCGGTCCATTCGAATGCT
GGCTCGCGTGTGCACCTGT -> GCTCGCGTGTGCACCTGTA
ATCTTGACTCAATCTCAGT -> TCTTGACTCAATCTCAGTC
AGCTGATCGAGAGGACATG -> GCTGATCGAGAGGACATGT
CCCATAGAAATGTTAAGGT -> CCATAGAAATGTTAAGGTC
TGCCCCACGTAACCTTGGT -> GCCCCACGTAACCTTGGTA
GGATTACGGCATTATAGGA -> GATTACGGCATTATAGGAA
TACGAGAGGGCCGCCGCAT -> ACGAGAGGGCCGCCGCATC
AACTTTATCATATGCGATC -> ACTTTATCATATGCGATCA
TCAAGGAGCCACTAGTCTG -> CAAGGAGCCACTAGTCTGA,CAAGGAGCCACTAGTCTGT,CAAGGAGCCACTAGTCTGT,CAAGGAGCCACTAGTCTGT
AAATTAATACCGGAACCTT -> AATTAATACCGGAACCTTA
CCCATTTGTATTTAAAGAT -> CCATTTGTATTTAAAGATC
CTACCTATATCCGCGGCCG -> TACCTATATCCGCGGCCGA
CAAATTTGTGTACCATAGA -> AAATTTGTGTACCATAGAT
CCTAACTTTATCATATGCG -> CTAACTTTATCATATGCGA
ATTCAGAGTGCGAATACGC -> TTCAGAGTGCGAATACGCG
CTGGGAGCGAAGCACTGAC -> TGGGAGCGAAGCACTGACG
GCCCAGTGCAACAATAATT -> CCCAGTGCAACAATAATTC
TCTGACCTCTTGAGCACGC -> CTGACCTCTTGAGCACGCA
ATTATGACCTAATCTGCCG -> TTATGACCTAATCTGCCGT
TTTAGGGACCCGTTGAGTT -> TTAGGGACCCGTTGAGTTC
TCTGTATTGCTTTGGTTTG -> CTGTATTGCTTTGGTTTGT
CCGGGATTTAATAGCAAGG -> CGGGATTTAATAGCAAGGG
GTTAAGGTCAGTCTTGAGA -> TTAAGGTCAGTCTTGAGAT
GGTACCTCTCGTCTGGTGA -> GTACCTCTCGTCTGGTGAC
ATTGGATTACGGCATTATA -> TTGGATTACGGCATTATAG
AATTTTGTTTGCCCCACGT -> ATTTTGTTTGCCCCACGTA
TCTAATTAGCCCGGCTCGC -> CTAATTAGCCCGGCTCGCG
AGCCCGGCTCGCGTGTGCA -> GCCCGGCTCGCGTGTGCAC
CTTGCTACCATAGTTTAGG -> TTGCTACCATAGTTTAGGG
CGAGAGGGCCGCCGCATCT -> GAGAGGGCCGCCGCATCTG
GAGGGTAGTATAGCCCTGG -> AGGGTAGTATAGCCCTGGC
AAAGATCGTAGAGGGTAGT -> AAGATCGTAGAGGGTAGTA
ACAAACAAACGGGACGCTA -> CAAACAAACGGGACGCTAC
GATCAAAACTCGCCGAAGA -> ATCAAAACTCGCCGAAGAC
TACGAAGCTGATCGAGAGG -> ACGAAGCTGATCGAGAGGA
CGATAGAGCCACAAACAAA -> GATAGAGCCACAAACAAAC
CGCAACACGTTGCTGTACT -> GCAACACGTTGCTGTACTA
TGGAGTTATATTATGGAAT -> GGAGTTATATTATGGAATT
CGATCCGGTCTGGGAGCGA -> GATCCGGTCTGGGAGCGAA
AATCTCGACAAATTTGTGT -> ATCTCGACAAATTTGTGTA
CCTTGGTAAGTGTACCAGT -> CTTGGTAAGTGTACCAGTT
GTCGGTCCATTCGAATGCT -> TCGGTCCATTCGAATGCTG
CCATTCCACTTCGCCTTCG -> CATTCCACTTCGCCTTCGT
CGTTCGTTGTCCTCAACTC -> GTTCGTTGTCCTCAACTCC
GCGAATCGCTGGCGACGCA -> CGAATCGCTGGCGACGCAG
TAGAACCACACCTAATGCA -> AGAACCACACCTAATGCAG
CGTAGTAGAAGCCGCAGAG -> GTAGTAGAAGCCGCAGAGC
TCGAATTCGATTGCGCAGA -> CGAATTCGATTGCGCAGAG
CCCGTACCGCGAGCGGGTG -> CCGTACCGCGAGCGGGTGC
GTCTGGGAGCGAAGCACTG -> TCTGGGAGCGAAGCACTGA
GCAGCCGCCGACCACCGTG -> CAGCCGCCGACCACCGTGG
GGGCTACGAGAGGGCCGCC -> GGCTACGAGAGGGCCGCCG
TCAGCAGAACGCCCGGTCG -> CAGCAGAACGCCCGGTCGG
AAACCACGATGGAGTAATG -> AACCACGATGGAGTAATGG
ACAGATTTCCTTTAGCTGA -> CAGATTTCCTTTAGCTGAT
AGCTTCAAAGGATGCTAAG -> GCTTCAAAGGATGCTAAGA
ATAGAAATGTTAAGGTCAG -> TAGAAATGTTAAGGTCAGT
CCCCCAACGATGGATTCCA -> CCCCAACGATGGATTCCAC
GCCACTAGTCTGTATATCC -> CCACTAGTCTGTATATCCG
ACCACCTAATTCTGGGCTA -> CCACCTAATTCTGGGCTAA
CGTTATCGAAGCCGGGATT -> GTTATCGAAGCCGGGATTT
TGTACGGAACCTCGGTCTC -> GTACGGAACCTCGGTCTCT
CAACGTATCATTCAAGGAG -> AACGTATCATTCAAGGAGC
TGCGAATACGCGCAACACG -> GCGAATACGCGCAACACGT
CCATAGTTTAGGGACCCGT -> CATAGTTTAGGGACCCGTT
ACTGACGACGTAGTTTGAC -> CTGACGACGTAGTTTGACG
GATGCTAAGATAAGCTCAC -> ATGCTAAGATAAGCTCACC
TAGTATAGCCCTGGCGGAC -> AGTATAGCCCTGGCGGACC
ATAGAGCCACAAACAAACG -> TAGAGCCACAAACAAACGG
CGTTGCTTTCCCGAGTTTT -> GTTGCTTTCCCGAGTTTTT
CGGTAACCGTTCGTTGTCC -> GGTAACCGTTCGTTGTCCT
CACTGCTACAACAACTCCT -> ACTGCTACAACAACTCCTG
AGACCACCTAATTCTGGGC -> GACCACCTAATTCTGGGCT
GATGAATCCTGTAACAAAC -> ATGAATCCTGTAACAAACC
ATTCAATCTTGACTCAATC -> TTCAATCTTGACTCAATCT
GCGCAACACGTTGCTGTAC -> CGCAACACGTTGCTGTACT
TGTCCTTCTTGACCTGTAG -> GTCCTTCTTGACCTGTAGA
CCGCATGCATCTTTTAAGG -> CGCATGCATCTTTTAAGGC
TTAAGTAATATAAGTGCCC -> TAAGTAATATAAGTGCCCA
AGTACCTAATCTGACCAAT -> GTACCTAATCTGACCAATC
TTCAATCTTGACTCAATCT -> TCAATCTTGACTCAATCTC
ATGCGTCACTTAGCCCACC -> TGCGTCACTTAGCCCACCG
ATGTTTTCCTACCAAGATA -> TGTTTTCCTACCAAGATAG
TGTAATTATGACCTAATCT -> GTAATTATGACCTAATCTG
TGTACCAGTTGTTTATGTT -> GTACCAGTTGTTTATGTTT
CGCAGGACGTAGTAGAAGC -> GCAGGACGTAGTAGAAGCC
TGATAGCTAATAACGGTAA -> GATAGCTAATAACGGTAAC
GGAGTAATGGAGTTATATT -> GAGTAATGGAGTTATATTA
GAGTTCCATTCCACTTCGC -> AGTTCCATTCCACTTCGCC
TCCTACCAAGATAGCTCGT -> CCTACCAAGATAGCTCGTA
GGGTGACGGCTGCAATTCA -> GGTGACGGCTGCAATTCAA
GTGGACAGGAATAGTGACG -> TGGACAGGAATAGTGACGC
TCAGGTGCTAGTTATGACT -> CAGGTGCTAGTTATGACTA
TTTTACCCTCCTAAGGTCA -> TTTACCCTCCTAAGGTCAT
AGCGATGAATCCTGTAACA -> GCGATGAATCCTGTAACAA
ACTTTGCCTTGTGCGTATC -> CTTTGCCTTGTGCGTATCC
TATCAAGGAGCCACTAGTC -> ATCAAGGAGCCACTAGTCT
CGCTACGAAGCTGATCGAG -> GCTACGAAGCTGATCGAGA
GTGCTAGTTATGACTAATT -> TGCTAGTTATGACTAATTT
TGGGAGCGAAGCACTGACG -> GGGAGCGAAGCACTGACGA
CGCATGCATCTTTTAAGGC -> GCATGCATCTTTTAAGGCG
TATCCGACGTTATCGAAGC -> ATCCGACGTTATCGAAGCC
GAGCGGGTGGAGCGCGGGT -> AGCGGGTGGAGCGCGGGTA
TAGGACACTCCTATTGTCT -> AGGACACTCCTATTGTCTC
TGGATTACGGCATTATAGG -> GGATTACGGCATTATAGGA
GTTTTTTGTACGGAACCTC -> TTTTTTGTACGGAACCTCG
CCTTCGTTTCTACCGAACA -> CTTCGTTTCTACCGAACAG
CATTTAAACAATAAGGGCC -> ATTTAAACAATAAGGGCCT
CTGATCACACCACCCACTT -> TGATCACACCACCCACTTT
GAGCCACTAGTCTGTATAT -> AGCCACTAGTCTGTATATC
GCCCATTTGTATTTAAAGA -> CCCATTTGTATTTAAAGAT
ACGATGGATTCCACCGAAC -> CGATGGATTCCACCGAACC
CAATCTTGACTCAATCTCA -> AATCTTGACTCAATCTCAG
ACTTCCGTACCGCGAGCGG -> CTTCCGTACCGCGAGCGGG
CACTTAGCCCACCGGCAGG -> ACTTAGCCCACCGGCAGGG
GGGCGGTCGGTCCATTCGA -> GGCGGTCGGTCCATTCGAA
AATTTGGAAGCCTTCGAGC -> ATTTGGAAGCCTTCGAGCT
TGGCTGCACCTGTCGACCA -> GGCTGCACCTGTCGACCAG
CTTGAGATGATACCGCATG -> TTGAGATGATACCGCATGC
CCCGGCTCGCGTGTGCACC -> CCGGCTCGCGTGTGCACCT
CCGATCCGGACGAGTTGGC -> CGATCCGGACGAGTTGGCA
ACGGATTGGAGAACCAGGC -> CGGATTGGAGAACCAGGCG
CGTGAACTCTATTACGATA -> GTGAACTCTATTACGATAG
TAGTAGAAGCCGCAGAGCC -> AGTAGAAGCCGCAGAGCCC
CTAAGATAAGCTCACCCAC -> TAAGATAAGCTCACCCACG
TACCCTCGAATGCATTACA -> ACCCTCGAATGCATTACAG
TACGATAGGTAGTACATCT -> ACGATAGGTAGTACATCTC
GAGTACCTAATCTGACCAA -> AGTACCTAATCTGACCAAT
TTCTGAACTGCCGCTAGGA -> TCTGAACTGCCGCTAGGAT
TCACACCACCCACTTTGCC -> CACACCACCCACTTTGCCT
CTCTCCTCCTGTACTGGGT -> TCTCCTCCTGTACTGGGTA
GTACGAATCACTGCTACAA -> TACGAATCACTGCTACAAC
TCGACTGATGAGGGTTAAT -> CGACTGATGAGGGTTAATC
TCAATCTCAGTCGAATTCG -> CAATCTCAGTCGAATTCGA
TGACTTATGCCGTACCGCG -> GACTTATGCCGTACCGCGA
AGTACATCTCGCTTAGCGA -> GTACATCTCGCTTAGCGAT
TTAATAGCAAGGGATCGTA -> TAATAGCAAGGGATCGTAG
CGTAGAGGGTAGTATAGCC -> GTAGAGGGTAGTATAGCCC
ATAACGGTAACCGTTCGTT -> TAACGGTAACCGTTCGTTG
CTCCAACTCCGTACGAATC -> TCCAACTCCGTACGAATCA
ATGCGCCGAATCAACTTCA -> TGCGCCGAATCAACTTCAG
CGCCTCGATCAAAACTCGC -> GCCTCGATCAAAACTCGCC
CGAATCGCTGGCGACGCAG -> GAATCGCTGGCGACGCAGG
ACGGTTGGCACGGTCATGG -> CGGTTGGCACGGTCATGGG
TTCCTTTAGCTGATGTAGG -> TCCTTTAGCTGATGTAGGG
TGGAAGCCTTCGAGCTTCA -> GGAAGCCTTCGAGCTTCAA
ATCAACTTCAGGGACTTTA -> TCAACTTCAGGGACTTTAT
GTCCATTCGAATGCTGCAC -> TCCATTCGAATGCTGCACC
ACCCCCAACGATGGATTCC -> CCCCCAACGATGGATTCCA
CCCCAACGTTCGGGCGGTC -> CCCAACGTTCGGGCGGTCG
GGGTGTACATTTACCATCA -> GGTGTACATTTACCATCAA
AACCGTTCGTTGTCCTCAA -> ACCGTTCGTTGTCCTCAAC
GCCTTCAGCAGCCAGCGAA -> CCTTCAGCAGCCAGCGAAC
ACCTAATCTGCCGTCGTCC -> CCTAATCTGCCGTCGTCCG
ACGGCTGCAATTCAAGGAG -> CGGCTGCAATTCAAGGAGC
TATGGAATTAGGACACTCC -> ATGGAATTAGGACACTCCT
TACGAATCACTGCTACAAC -> ACGAATCACTGCTACAACA
CACGCAGGGTCCTGTGGAC -> ACGCAGGGTCCTGTGGACA
AGAGCCACAAACAAACGGG -> GAGCCACAAACAAACGGGA
TTGTACGGAACCTCGGTCT -> TGTACGGAACCTCGGTCTC
CCTAATCTGCCGTCGTCCG -> CTAATCTGCCGTCGTCCGA
CGTAGTTTGACGACCGAAC -> GTAGTTTGACGACCGAACT
AGCCACTAGTCTGTATTGC -> GCCACTAGTCTGTATTGCT
CGATTGCGCAGAGGGCGCC -> GATTGCGCAGAGGGCGCCC
CAGGAGTACCTTCACGCGA -> AGGAGTACCTTCACGCGAT
GGACCCGTTGAGTTCCATT -> GACCCGTTGAGTTCCATTC
ATTATAGGAATTTTGTTTG -> TTATAGGAATTTTGTTTGC
TCTTGACTCAATCTCAGTC -> CTTGACTCAATCTCAGTCG
TTATGACCTAATCTGCCGT -> TATGACCTAATCTGCCGTC
ATCATTCAAGGAGCCACTA -> TCATTCAAGGAGCCACTAG
AAACCAGAAAACAATACTA -> AACCAGAAAACAATACTAC
GGTCGGATATACGGTTGGC -> GTCGGATATACGGTTGGCA
TATACTTTCAACACCGTAC -> ATACTTTCAACACCGTACC
TACCGCGAGCGGGTGTACA -> ACCGCGAGCGGGTGTACAT
TTCACGCGATCCGGTCTGG -> TCACGCGATCCGGTCTGGG
CTCGTCTGGTGACTTATGC -> TCGTCTGGTGACTTATGCC
AGAACCAGGCGCTTTGAAC -> GAACCAGGCGCTTTGAACA
TCAAAGTGCGTTCGGGCCT -> CAAAGTGCGTTCGGGCCTC
CCGTACCGCGAGCGGGTGT -> CGTACCGCGAGCGGGTGTA
CGTCACTTAGCCCACCGGC -> GTCACTTAGCCCACCGGCA
AAATGTTAAGGTCAGTCTT -> AATGTTAAGGTCAGTCTTG
ATTTAATAGCAAGGGATCG -> TTTAATAGCAAGGGATCGT
TGAATCCTGTAACAAACCC -> GAATCCTGTAACAAACCCT
CGTTGTCCTCAACTCCGTG -> GTTGTCCTCAACTCCGTGG
ACCCATAGAAATGTTAAGG -> CCCATAGAAATGTTAAGGT
CCTTACAGTTATCCGACGT -> CTTACAGTTATCCGACGTT
CCAATGACTATGGCTAATG -> CAATGACTATGGCTAATGC
CTCGACAAATTTGTGTACC -> TCGACAAATTTGTGTACCA
GTAGAAGCCGCAGAGCCCG -> TAGAAGCCGCAGAGCCCGT
AATTTGAATACTCCCCAAA -> ATTTGAATACTCCCCAAAT
ATGAGGGTTAATCTCGACA -> TGAGGGTTAATCTCGACAA
GTATAGCCCTGGCGGACCC -> TATAGCCCTGGCGGACCCC
AGTCTTGAGATGATACCGC -> GTCTTGAGATGATACCGCA
GGGACAGTCCTAATGTAGA -> GGACAGTCCTAATGTAGAC
AACAAACGGGACGCTACGA -> ACAAACGGGACGCTACGAA
CTGGCGACGCAGGAGTACC -> TGGCGACGCAGGAGTACCT
AACAATACTACGGATTGGA -> ACAATACTACGGATTGGAG
AAATTAGCAGTGCATTGGA -> AATTAGCAGTGCATTGGAT
GACGGCTGCAATTCAAGGA -> ACGGCTGCAATTCAAGGAG
TTGCCTGGATTTTACCCTC -> TGCCTGGATTTTACCCTCC
CCCGTTTGCCTGGATTTTA -> CCGTTTGCCTGGATTTTAC
GCTTTCCCGAGTTTTTTGT -> CTTTCCCGAGTTTTTTGTA
ACCGCGAGCGGGTGACGGC -> CCGCGAGCGGGTGACGGCT
TATTGCTTTGGTTTGTGGC -> ATTGCTTTGGTTTGTGGCG
GCCTTGTGCGTATCCTAAC -> CCTTGTGCGTATCCTAACT
CGTAACCTTGGTAAGTGTA -> GTAACCTTGGTAAGTGTAC
ACCAAGATAGCTCGTATAC -> CCAAGATAGCTCGTATACT
GCCACTAGTCTGACCTCTT -> CCACTAGTCTGACCTCTTG
CGGTCTCTTTATGTTAGCA -> GGTCTCTTTATGTTAGCAC
ACTAGGAGTACCTAATCTG -> CTAGGAGTACCTAATCTGA
GTACCGCGAGCGGGTGCAA -> TACCGCGAGCGGGTGCAAC
GACCCGTTGAGTTCCATTC -> ACCCGTTGAGTTCCATTCC
ACCCTCCTAAGGTCATAGC -> CCCTCCTAAGGTCATAGCC
AAGCCTTGGACCACTTCCG -> AGCCTTGGACCACTTCCGT
AATTATGACCTAATCTGCC -> ATTATGACCTAATCTGCCG
CGGTCTGGGAGCGAAGCAC -> GGTCTGGGAGCGAAGCACT
ATCCGGACGAGTTGGCATG -> TCCGGACGAGTTGGCATGC
AAGATAAGCTCACCCACGA -> AGATAAGCTCACCCACGAA
CTTCAGGGACTTTATATCG -> TTCAGGGACTTTATATCGA
CTCGGTCTCTTTATGTTAG -> TCGGTCTCTTTATGTTAGC
GTATAGCCGCTTACCTAAA -> TATAGCCGCTTACCTAAAC
GACTAATTTGAATACTCCC -> ACTAATTTGAATACTCCCC
TTCCATTCCACTTCGCCTT -> TCCATTCCACTTCGCCTTC
TTCGCCTTCGTTTCTACCG -> TCGCCTTCGTTTCTACCGA
CCAAATTAATACCGGAACC -> CAAATTAATACCGGAACCT
TTGCTTTGGTTTGTGGCGA -> TGCTTTGGTTTGTGGCGAA
AAAGGATGCTAAGATAAGC -> AAGGATGCTAAGATAAGCT
AGGTCAGTCTTGAGATGAT -> GGTCAGTCTTGAGATGATA
AAGCCGCAGAGCCCGTTTG -> AGCCGCAGAGCCCGTTTGC
CGACGTTATCGAAGCCGGG -> GACGTTATCGAAGCCGGGA
AGCCGCTTACCTAAACCAG -> GCCGCTTACCTAAACCAGA
CCCAACGATGGATTCCACC -> CCAACGATGGATTCCACCG
GACGCAGGACGTAGTAGAA -> ACGCAGGACGTAGTAGAAG
ATAGTGACGCTGATCACAC -> TAGTGACGCTGATCACACC
TCTGAACTGCCGCTAGGAT -> CTGAACTGCCGCTAGGATG
TTGTGCGTATCCTAACTTT -> TGTGCGTATCCTAACTTTA
TACGGCATTATAGGAATTT -> ACGGCATTATAGGAATTTT
TGCATCTTTTAAGGCGCCT -> GCATCTTTTAAGGCGCCTC
CACTAGTCTGTAACGGTCC -> ACTAGTCTGTAACGGTCCG
TCGAGAGGACATGTCCAAG -> CGAGAGGACATGTCCAAGC
GTTATGACTAATTTGAATA -> TTATGACTAATTTGAATAC
GCAGGAGTACCTTCACGCG -> CAGGAGTACCTTCACGCGA
GGTTAATCTCGACAAATTT -> GTTAATCTCGACAAATTTG
CCGGTCTGGGAGCGAAGCA -> CGGTCTGGGAGCGAAGCAC
AACTCGCCGAAGACGCTAT -> ACTCGCCGAAGACGCTATT
TAACCGTTCGTTGTCCTCA -> AACCGTTCGTTGTCCTCAA
AATTCAGAGTGCGAATACG -> ATTCAGAGTGCGAATACGC
CAGAACGCCCGGTCGGATA -> AGAACGCCCGGTCGGATAT
CTGAACTGCCGCTAGGATG -> TGAACTGCCGCTAGGATGT
AGCTACCTATATCCGCGGC -> GCTACCTATATCCGCGGCC
TATAAGTGCCCATTTGTAT -> ATAAGTGCCCATTTGTATT
CTCCGTACGAATCACTGCT -> TCCGTACGAATCACTGCTA
GGTTTGTGGCGAATCGCTG -> GTTTGTGGCGAATCGCTGG
GTGGCGTGAACTCTATTAC -> TGGCGTGAACTCTATTACG
CTACGAAGCTGATCGAGAG -> TACGAAGCTGATCGAGAGG
ACGTATCATTCAAGGAGCC -> CGTATCATTCAAGGAGCCA
GGAGCCACTAGTCTGTATA -> GAGCCACTAGTCTGTATAT
AGGGCCTTCAGCAGCCAGC -> GGGCCTTCAGCAGCCAGCG
TTCCTACCAAGATAGCTCG -> TCCTACCAAGATAGCTCGT
TGTATATCCGTCGGGAGTA -> GTATATCCGTCGGGAGTAC
CAATAAGGGCCTTCAGCAG -> AATAAGGGCCTTCAGCAGC
ACGCAGGGTCCTGTGGACA -> CGCAGGGTCCTGTGGACAG
TAGTCTGTAACGGTCCGTG -> AGTCTGTAACGGTCCGTGC
GCAGAGGGCGCCCCAACGT -> CAGAGGGCGCCCCAACGTT
AGTAATATAAGTGCCCATT -> GTAATATAAGTGCCCATTT
ACCTCGGTCTCTTTATGTT -> CCTCGGTCTCTTTATGTTA
CTGACCTCTTGAGCACGCA -> TGACCTCTTGAGCACGCAG
ACGCTATTCAATCTTGACT -> CGCTATTCAATCTTGACTC
GGCCTTCAGCAGAACGCCC -> GCCTTCAGCAGAACGCCCG
GGCTCCAACTCCGTACGAA -> GCTCCAACTCCGTACGAAT
CGGGTGGAGCGCGGGTATC -> GGGTGGAGCGCGGGTATCA
CGAATCAACTTCAGGGACT -> GAATCAACTTCAGGGACTT
TAAGCCTTGGACCACTTCC -> AAGCCTTGGACCACTTCCG
GTAACCCATAGAAATGTTA -> TAACCCATAGAAATGTTAA
CACCTGTAATTATGACCTA -> ACCTGTAATTATGACCTAA
ACCTAATCTGACCAATCTA -> CCTAATCTGACCAATCTAA
ACCTTGGTAAGTGTACCAG -> CCTTGGTAAGTGTACCAGT
TTTTCCTACCAAGATAGCT -> TTTCCTACCAAGATAGCTC
TCCACTTCGCCTTCGTTTC -> CCACTTCGCCTTCGTTTCT
GGAGTACCTTCACGCGATC -> GAGTACCTTCACGCGATCC
TTTGGTTTGTGGCGAATCG -> TTGGTTTGTGGCGAATCGC
AACGGTAACCGTTCGTTGT -> ACGGTAACCGTTCGTTGTC
GATAAGCTCACCCACGAAA -> ATAAGCTCACCCACGAAAT
CCTTTAGCTGATGTAGGGC -> CTTTAGCTGATGTAGGGCT
TAATTAGCCCGGCTCGCGT -> AATTAGCCCGGCTCGCGTG
TGGAATTAGGACACTCCTA -> GGAATTAGGACACTCCTAT
ACACATTTCTGAACTGCCG -> CACATTTCTGAACTGCCGC
GGTCAGTCTTGAGATGATA -> GTCAGTCTTGAGATGATAC
GGGCTAAGCCTTGGACCAC -> GGCTAAGCCTTGGACCACT
CACCACCCACTTTGCCTTG -> ACCACCCACTTTGCCTTGT
ATAGGAATTTTGTTTGCCC -> TAGGAATTTTGTTTGCCCC
TACCATAGATCGGCTTAAG -> ACCATAGATCGGCTTAAGT
CTTAGCCCACCGGCAGGGT -> TTAGCCCACCGGCAGGGTA
GCCGCTTACCTAAACCAGA -> CCGCTTACCTAAACCAGAA
AGACGCTATTCAATCTTGA -> GACGCTATTCAATCTTGAC
CGGCTTAAGTAATATAAGT -> GGCTTAAGTAATATAAGTG
AGCACGCAGGGTCCTGTGG -> GCACGCAGGGTCCTGTGGA
AATTAGCAGTGCATTGGAT -> ATTAGCAGTGCATTGGATT
TGATCGAGAGGACATGTCC -> GATCGAGAGGACATGTCCA
TCGGGCGGTCGGTCCATTC -> CGGGCGGTCGGTCCATTCG
CACTCCTATTGTCTCCACA -> ACTCCTATTGTCTCCACAG
GAAATCCACCGCCATTGTG -> AAATCCACCGCCATTGTGA
CCTACCAAGATAGCTCGTA -> CTACCAAGATAGCTCGTAT
AGAGGGTAGTATAGCCCTG -> GAGGGTAGTATAGCCCTGG
CTGGTGACTTATGCCGTAC -> TGGTGACTTATGCCGTACC
GAATGCTGCACCCGATAGA -> AATGCTGCACCCGATAGAG
CACACCTAATGCAGCCGCC -> ACACCTAATGCAGCCGCCG
TCTCCTCCTGTACTGGGTA -> CTCCTCCTGTACTGGGTAA
CGCGCAACACGTTGCTGTA -> GCGCAACACGTTGCTGTAC
CCGTGCATGGAGTATAGCC -> CGTGCATGGAGTATAGCCG
TGTACATTTACCATCAAGG -> GTACATTTACCATCAAGGA
ACCAATCTAATTAGCCCGG -> CCAATCTAATTAGCCCGGC
AATCTGCCGTCGTCCGATA -> ATCTGCCGTCGTCCGATAC
CAACGTTCGGGCGGTCGGT -> AACGTTCGGGCGGTCGGTC
AAACTCGCCGAAGACGCTA -> AACTCGCCGAAGACGCTAT
TGGCGTGAACTCTATTACG -> GGCGTGAACTCTATTACGA
CAGAGGGCGCCCCAACGTT -> AGAGGGCGCCCCAACGTTC
TAAGGTCAGTCTTGAGATG -> AAGGTCAGTCTTGAGATGA
CACTTCGCCTTCGTTTCTA -> ACTTCGCCTTCGTTTCTAC
GAGATGATACCGCATGCAT -> AGATGATACCGCATGCATC
CCTCTCGTCTGGTGACTTA -> CTCTCGTCTGGTGACTTAT
ATCGACTGATGAGGGTTAA -> TCGACTGATGAGGGTTAAT
CAATCTCAGTCGAATTCGA -> AATCTCAGTCGAATTCGAT
TCGACCAGATGGGATGCGT -> CGACCAGATGGGATGCGTC
GCCGTACCGCGAGCGGGTG -> CCGTACCGCGAGCGGGTGG
CGGGACGCTACGAAGCTGA -> GGGACGCTACGAAGCTGAT
ATCACACCACCCACTTTGC -> TCACACCACCCACTTTGCC
ATACTACGGATTGGAGAAC -> TACTACGGATTGGAGAACC
ATGACTAATTTGAATACTC -> TGACTAATTTGAATACTCC
GCATGGAGTATAGCCGCTT -> CATGGAGTATAGCCGCTTA
TGACTAATTTGAATACTCC -> GACTAATTTGAATACTCCC
ACGGCATTATAGGAATTTT -> CGGCATTATAGGAATTTTG
TCCTGACTGCTATCGGAGG -> CCTGACTGCTATCGGAGGG
CGAAGCACTGACGACGTAG -> GAAGCACTGACGACGTAGT
ACAACAACTCCTGACTGCT -> CAACAACTCCTGACTGCTA
AGCAGCCAGCGAACGAAAC -> GCAGCCAGCGAACGAAACC
ACAAATTTGTGTACCATAG -> CAAATTTGTGTACCATAGA
TCTCGTCTGGTGACTTATG -> CTCGTCTGGTGACTTATGC
TGATGAGGGTTAATCTCGA -> GATGAGGGTTAATCTCGAC
TATGCGATCAAAGTGCGTT -> ATGCGATCAAAGTGCGTTC
TATTACGATAGGTAGTACA -> ATTACGATAGGTAGTACAT
TTACGGCATTATAGGAATT -> TACGGCATTATAGGAATTT
CTAATTCTGGGCTAAGCCT -> TAATTCTGGGCTAAGCCTT
GCACTGACGACGTAGTTTG -> CACTGACGACGTAGTTTGA
AATATAAGTGCCCATTTGT -> ATATAAGTGCCCATTTGTA
ACAGTCCTAATGTAGACGC -> CAGTCCTAATGTAGACGCA
TCAGTCTTGAGATGATACC -> CAGTCTTGAGATGATACCG
GATTCCACCGAACCCGTAC -> ATTCCACCGAACCCGTACC
ATCGCTGGCGACGCAGGAG -> TCGCTGGCGACGCAGGAGT
AAGGATGCTAAGATAAGCT -> AGGATGCTAAGATAAGCTC
TTCAGAGTGCGAATACGCG -> TCAGAGTGCGAATACGCGC
TAGGATGTCCTTCTTGACC -> AGGATGTCCTTCTTGACCT
ATTTACCATCAAGGAGCCA -> TTTACCATCAAGGAGCCAC
GTATCAAGGAGCCACTAGT -> TATCAAGGAGCCACTAGTC
GAGCGGGTGACGGCTGCAA -> AGCGGGTGACGGCTGCAAT
ATATCCGCGGCCGATCCGG -> TATCCGCGGCCGATCCGGA
TACCTCTCGTCTGGTGACT -> ACCTCTCGTCTGGTGACTT
AATCGCTGGCGACGCAGGA -> ATCGCTGGCGACGCAGGAG
TCAGAGTGCGAATACGCGC -> CAGAGTGCGAATACGCGCA
TTAAGGCGCCTCGATCAAA -> TAAGGCGCCTCGATCAAAA
TGACTCAATCTCAGTCGAA -> GACTCAATCTCAGTCGAAT
GCGGCCGATCCGGACGAGT -> CGGCCGATCCGGACGAGTT
GATAGCTAATAACGGTAAC -> ATAGCTAATAACGGTAACC
AGAGCTACCTATATCCGCG -> GAGCTACCTATATCCGCGG
TGACCTCTTGAGCACGCAG -> GACCTCTTGAGCACGCAGG
GGGACTTTATATCGACTGA -> GGACTTTATATCGACTGAT
AGCGGGTGACGGCTGCAAT -> GCGGGTGACGGCTGCAATT
ACCGAACCCGTACCGCGAG -> CCGAACCCGTACCGCGAGC
ACGGAACCTCGGTCTCTTT -> CGGAACCTCGGTCTCTTTA
CCAGGCGCTTTGAACATGG -> CAGGCGCTTTGAACATGGC
AGTGCGTTCGGGCCTCCCA -> GTGCGTTCGGGCCTCCCAA
GGAATTTTGTTTGCCCCAC -> GAATTTTGTTTGCCCCACG
CATGCGCCGAATCAACTTC -> ATGCGCCGAATCAACTTCA
GAGCCACTAGTCTGTAACG -> AGCCACTAGTCTGTAACGG
TTGTTTGCCCCACGTAACC -> TGTTTGCCCCACGTAACCT
CAGAATTGCTCAAACGGGC -> AGAATTGCTCAAACGGGCT
TGCTACCATAGTTTAGGGA -> GCTACCATAGTTTAGGGAC
GGGTACCTCTCGTCTGGTG -> GGTACCTCTCGTCTGGTGA
CGAACAGATTTCCTTTAGC -> GAACAGATTTCCTTTAGCT
ACCCGTACCGCGAGCGGGT -> CCCGTACCGCGAGCGGGTG
CGACAAATTTGTGTACCAT -> GACAAATTTGTGTACCATA
ACGTTATCGAAGCCGGGAT -> CGTTATCGAAGCCGGGATT
GTACTGGGTAACCCATAGA -> TACTGGGTAACCCATAGAA
TGATCACACCACCCACTTT -> GATCACACCACCCACTTTG
ATTTGAATACTCCCCAAAT -> TTTGAATACTCCCCAAATT
CTAGTTATGACTAATTTGA -> TAGTTATGACTAATTTGAA
CAGTCTTGAGATGATACCG -> AGTCTTGAGATGATACCGC
GGGTTAATCTCGACAAATT -> GGTTAATCTCGACAAATTT
GACCAATCTAATTAGCCCG -> ACCAATCTAATTAGCCCGG
GTCCTCAACTCCGTGGCGT -> TCCTCAACTCCGTGGCGTG
GCTAATAACGGTAACCGTT -> CTAATAACGGTAACCGTTC
GACCTGTAGAGCTACCTAT -> ACCTGTAGAGCTACCTATA
TGACCTGTAGAGCTACCTA -> GACCTGTAGAGCTACCTAT
TTACAGAGCTCGTAGAACC -> TACAGAGCTCGTAGAACCA
ACTTTATATCGACTGATGA -> CTTTATATCGACTGATGAG
TTCAAAGGATGCTAAGATA -> TCAAAGGATGCTAAGATAA
ACCACGATGGAGTAATGGA -> CCACGATGGAGTAATGGAG
GAACCCGTACCGCGAGCGG -> AACCCGTACCGCGAGCGGG
AGCCCACCGGCAGGGTACC -> GCCCACCGGCAGGGTACCT
CGAGCTTCAAAGGATGCTA -> GAGCTTCAAAGGATGCTAA
TACGGTTGGCACGGTCATG -> ACGGTTGGCACGGTCATGG
CGTATACTTTCAACACCGT -> GTATACTTTCAACACCGTA
TTCAACACCGTACCGCGAG -> TCAACACCGTACCGCGAGC
ATGTAGGGCTACGAGAGGG -> TGTAGGGCTACGAGAGGGC
TGTTTATGTTTTCCTACCA -> GTTTATGTTTTCCTACCAA
CCGATAGAGCCACAAACAA -> CGATAGAGCCACAAACAAA
GCTAGGATGTCCTTCTTGA -> CTAGGATGTCCTTCTTGAC
CTGCCCAGTGCAACAATAA -> TGCCCAGTGCAACAATAAT
AGTTCCATTCCACTTCGCC -> GTTCCATTCCACTTCGCCT
AGGAGTACCTTCACGCGAT -> GGAGTACCTTCACGCGATC
CCATTCGAATGCTGCACCC -> CATTCGAATGCTGCACCCG
AGAATTGCTCAAACGGGCT -> GAATTGCTCAAACGGGCTC
CAGTCCTAATGTAGACGCA -> AGTCCTAATGTAGACGCAG
AAACAAACGGGACGCTACG -> AACAAACGGGACGCTACGA
GTTCCATTCCACTTCGCCT -> TTCCATTCCACTTCGCCTT
GGATTCCACCGAACCCGTA -> GATTCCACCGAACCCGTAC
TCACTTAGCCCACCGGCAG -> CACTTAGCCCACCGGCAGG
CGCAGGAGTACCTTCACGC -> GCAGGAGTACCTTCACGCG
TCCATTCCACTTCGCCTTC -> CCATTCCACTTCGCCTTCG
TTCTACCGAACAGATTTCC -> TCTACCGAACAGATTTCCT
TAGAAATGTTAAGGTCAGT -> AGAAATGTTAAGGTCAGTC
GTGCATGGAGTATAGCCGC -> TGCATGGAGTATAGCCGCT
AAGCTGATCGAGAGGACAT -> AGCTGATCGAGAGGACATG
AATTCGATTGCGCAGAGGG -> ATTCGATTGCGCAGAGGGC
ACGAGAGGGCCGCCGCATC -> CGAGAGGGCCGCCGCATCT
ATAGTTTAGGGACCCGTTG -> TAGTTTAGGGACCCGTTGA
CCGACCACCGTGGCTGCAC -> CGACCACCGTGGCTGCACC
TGACCAATCTAATTAGCCC -> GACCAATCTAATTAGCCCG
CGATAGGTAGTACATCTCG -> GATAGGTAGTACATCTCGC
AGAGCTCGTAGAACCACAC -> GAGCTCGTAGAACCACACC
ATATGCGATCAAAGTGCGT -> TATGCGATCAAAGTGCGTT
CGAATGCATTACAGAGCTC -> GAATGCATTACAGAGCTCG
ATGCAGCCGCCGACCACCG -> TGCAGCCGCCGACCACCGT
CCACAAACAAACGGGACGC -> CACAAACAAACGGGACGCT
AGTCTGTAACGGTCCGTGC -> GTCTGTAACGGTCCGTGCA
TGCTTTCCCGAGTTTTTTG -> GCTTTCCCGAGTTTTTTGT
TAAGGGCCTTCAGCAGCCA -> AAGGGCCTTCAGCAGCCAG
GACGTAGTAGAAGCCGCAG -> ACGTAGTAGAAGCCGCAGA
GCCCCAACGTTCGGGCGGT -> CCCCAACGTTCGGGCGGTC
AATGCAGCCGCCGACCACC -> ATGCAGCCGCCGACCACCG
CAAACCCTCTCCTCCTGTA -> AAACCCTCTCCTCCTGTAC
TCAGCAGCCAGCGAACGAA -> CAGCAGCCAGCGAACGAAA
GATACCCTCGAATGCATTA -> ATACCCTCGAATGCATTAC
GCGAATACGCGCAACACGT -> CGAATACGCGCAACACGTT
CTTTCCCGAGTTTTTTGTA -> TTTCCCGAGTTTTTTGTAC
AGCACTTTAAATTAGCAGT -> GCACTTTAAATTAGCAGTG
TTTTAAGGCGCCTCGATCA -> TTTAAGGCGCCTCGATCAA
CAGGACGTAGTAGAAGCCG -> AGGACGTAGTAGAAGCCGC
CAATAATTCAGAGTGCGAA -> AATAATTCAGAGTGCGAAT
TTCGAGCTTCAAAGGATGC -> TCGAGCTTCAAAGGATGCT
ACTAGTCTGTAACGGTCCG -> CTAGTCTGTAACGGTCCGT
TACCGCGAGCGGGTGGAGC -> ACCGCGAGCGGGTGGAGCG
TCCGATACCCTCGAATGCA -> CCGATACCCTCGAATGCAT
TATGTTAGCACTTTAAATT -> ATGTTAGCACTTTAAATTA
CTGTATTGCTTTGGTTTGT -> TGTATTGCTTTGGTTTGTG
GTACCTTCACGCGATCCGG -> TACCTTCACGCGATCCGGT
AACAATAATTCAGAGTGCG -> ACAATAATTCAGAGTGCGA
GCAAGGGATCGTAGACCAC -> CAAGGGATCGTAGACCACC
CCTCGAATGCATTACAGAG -> CTCGAATGCATTACAGAGC
GTTTTCCTACCAAGATAGC -> TTTTCCTACCAAGATAGCT
CACGCGATCCGGTCTGGGA -> ACGCGATCCGGTCTGGGAG
CTGTAACGGTCCGTGCATG -> TGTAACGGTCCGTGCATGG
GTACATTTAAACAATAAGG -> TACATTTAAACAATAAGGG
GCTTTGAACATGGCCTTCA -> CTTTGAACATGGCCTTCAG
CCCCAAATTAATACCGGAA -> CCCAAATTAATACCGGAAC
TTTACCATCAAGGAGCCAC -> TTACCATCAAGGAGCCACT
GAACTGCCGCTAGGATGTC -> AACTGCCGCTAGGATGTCC
CGCGGCCGATCCGGACGAG -> GCGGCCGATCCGGACGAGT
AATCAACTTCAGGGACTTT -> ATCAACTTCAGGGACTTTA
GTCTGACCTCTTGAGCACG -> TCTGACCTCTTGAGCACGC
CCAGCGAACGAAACCACGA -> CAGCGAACGAAACCACGAT
AGATCGGCTTAAGTAATAT -> GATCGGCTTAAGTAATATA
TGAATACTCCCCAAATTAA -> GAATACTCCCCAAATTAAT
AAAGTGCGTTCGGGCCTCC -> AAGTGCGTTCGGGCCTCCC
CATTGTGATAGCTAATAAC -> ATTGTGATAGCTAATAACG
TACAACAACTCCTGACTGC -> ACAACAACTCCTGACTGCT
GAAGCCTTCGAGCTTCAAA -> AAGCCTTCGAGCTTCAAAG
TCTTGACCTGTAGAGCTAC -> CTTGACCTGTAGAGCTACC
TACCGCATGCATCTTTTAA -> ACCGCATGCATCTTTTAAG
AAAACTCGCCGAAGACGCT -> AAACTCGCCGAAGACGCTA
CATTCAAGGAGCCACTAGT -> ATTCAAGGAGCCACTAGTC
TGAGTTCCATTCCACTTCG -> GAGTTCCATTCCACTTCGC
TTGCCTTGTGCGTATCCTA -> TGCCTTGTGCGTATCCTAA
AACCCATAGAAATGTTAAG -> ACCCATAGAAATGTTAAGG
TGAGATGATACCGCATGCA -> GAGATGATACCGCATGCAT
TTCAGGGACTTTATATCGA -> TCAGGGACTTTATATCGAC
ACACCACCCACTTTGCCTT -> CACCACCCACTTTGCCTTG
TTTGGAAGCCTTCGAGCTT -> TTGGAAGCCTTCGAGCTTC
TTGGAGAACCAGGCGCTTT -> TGGAGAACCAGGCGCTTTG
CTCCTAAGGTCATAGCCGT -> TCCTAAGGTCATAGCCGTT
TGTGCACCTGTAATTATGA -> GTGCACCTGTAATTATGAC
TTGTGGCGAATCGCTGGCG -> TGTGGCGAATCGCTGGCGA
CTATTCAATCTTGACTCAA -> TATTCAATCTTGACTCAAT
GACGACCGAACTGACTACA -> ACGACCGAACTGACTACAC
CTTGACTCAATCTCAGTCG -> TTGACTCAATCTCAGTCGA
ACCGTGGCTGCACCTGTCG -> CCGTGGCTGCACCTGTCGA
GCCGATCCGGACGAGTTGG -> CCGATCCGGACGAGTTGGC
ATTTAAAGATCGTAGAGGG -> TTTAAAGATCGTAGAGGGT
CCGTGGCTGCACCTGTCGA -> CGTGGCTGCACCTGTCGAC
CCGAATCAACTTCAGGGAC -> CGAATCAACTTCAGGGACT
GCGTCACTTAGCCCACCGG -> CGTCACTTAGCCCACCGGC
TGACGGCTGCAATTCAAGG -> GACGGCTGCAATTCAAGGA
AGTGACGCTGATCACACCA -> GTGACGCTGATCACACCAC
CTATTACGATAGGTAGTAC -> TATTACGATAGGTAGTACA
CGACCAGATGGGATGCGTC -> GACCAGATGGGATGCGTCA
GCCCACGTCCATCCACTTG -> CCCACGTCCATCCACTTGC
CTCGCCGAAGACGCTATTC -> TCGCCGAAGACGCTATTCA
CCGGTCGGATATACGGTTG -> CGGTCGGATATACGGTTGG
GTTTGTGGCGAATCGCTGG -> TTTGTGGCGAATCGCTGGC
TCCGCGGCCGATCCGGACG -> CCGCGGCCGATCCGGACGA
CTGACCAATCTAATTAGCC -> TGACCAATCTAATTAGCCC
ACCCTCTCCTCCTGTACTG -> CCCTCTCCTCCTGTACTGG
CCGGAACCTTACAGTTATC -> CGGAACCTTACAGTTATCC
TTTCTGAACTGCCGCTAGG -> TTCTGAACTGCCGCTAGGA
CGAACGAAACCACGATGGA -> GAACGAAACCACGATGGAG
CTCCGTGGCGTGAACTCTA -> TCCGTGGCGTGAACTCTAT
CCACAGCAATTTGGAAGCC -> CACAGCAATTTGGAAGCCT
TAAGATAAGCTCACCCACG -> AAGATAAGCTCACCCACGA
CATAGATCGGCTTAAGTAA -> ATAGATCGGCTTAAGTAAT
GCGTATCCTAACTTTATCA -> CGTATCCTAACTTTATCAT
GGAGTATAGCCGCTTACCT -> GAGTATAGCCGCTTACCTA
CACAGCAATTTGGAAGCCT -> ACAGCAATTTGGAAGCCTT
TGTAACAAACCCTCTCCTC -> GTAACAAACCCTCTCCTCC
GTGCCCATTTGTATTTAAA -> TGCCCATTTGTATTTAAAG
CTGATGTAGGGCTACGAGA -> TGATGTAGGGCTACGAGAG
GTCGGATATACGGTTGGCA -> TCGGATATACGGTTGGCAC
GGCCGCCGCATCTGCCCAG -> GCCGCCGCATCTGCCCAGT
CCCGGTCGGATATACGGTT -> CCGGTCGGATATACGGTTG
CCACTTCGCCTTCGTTTCT -> CACTTCGCCTTCGTTTCTA
ATGCTAAGATAAGCTCACC -> TGCTAAGATAAGCTCACCC
CGCTTAGCGATGAATCCTG -> GCTTAGCGATGAATCCTGT
CTGCACCTGTCGACCAGAT -> TGCACCTGTCGACCAGATG
GGGAGTACATTTAAACAAT -> GGAGTACATTTAAACAATA
CGAAACCACGATGGAGTAA -> GAAACCACGATGGAGTAAT
AACTGCCGCTAGGATGTCC -> ACTGCCGCTAGGATGTCCT
TCCACAGCAATTTGGAAGC -> CCACAGCAATTTGGAAGCC
ACTTAGCCCACCGGCAGGG -> CTTAGCCCACCGGCAGGGT
CCCTCCTAAGGTCATAGCC -> CCTCCTAAGGTCATAGCCG
TCGAAGCCGGGATTTAATA -> CGAAGCCGGGATTTAATAG
GTACCGCGAGCGGGTGACG -> TACCGCGAGCGGGTGACGG
ACCTTCACGCGATCCGGTC -> CCTTCACGCGATCCGGTCT
GCCGTCGTCCGATACCCTC -> CCGTCGTCCGATACCCTCG
CAGAGCTCGTAGAACCACA -> AGAGCTCGTAGAACCACAC
GGAAGCCTTCGAGCTTCAA -> GAAGCCTTCGAGCTTCAAA
ATTCGAATGCTGCACCCGA -> TTCGAATGCTGCACCCGAT
ACAGAGCTCGTAGAACCAC -> CAGAGCTCGTAGAACCACA
TTAGCGATGAATCCTGTAA -> TAGCGATGAATCCTGTAAC
TCCGTGCATGGAGTATAGC -> CCGTGCATGGAGTATAGCC
GATGTAGGGCTACGAGAGG -> ATGTAGGGCTACGAGAGGG
AACAATAAGGGCCTTCAGC -> ACAATAAGGGCCTTCAGCA
GAGCACGCAGGGTCCTGTG -> AGCACGCAGGGTCCTGTGG
AGGTAGTACATCTCGCTTA -> GGTAGTACATCTCGCTTAG
AAGCAGAATTGCTCAAACG -> AGCAGAATTGCTCAAACGG
GACTTTATATCGACTGATG -> ACTTTATATCGACTGATGA
TCTCGCTTAGCGATGAATC -> CTCGCTTAGCGATGAATCC
ATCTCGACAAATTTGTGTA -> TCTCGACAAATTTGTGTAC
CGTCTGGTGACTTATGCCG -> GTCTGGTGACTTATGCCGT
CTTGACCTGTAGAGCTACC -> TTGACCTGTAGAGCTACCT
ATAGCTCGTATACTTTCAA -> TAGCTCGTATACTTTCAAC
GGTAACCCATAGAAATGTT -> GTAACCCATAGAAATGTTA
CCTCTTGAGCACGCAGGGT -> CTCTTGAGCACGCAGGGTC
GCAACACGTTGCTGTACTA -> CAACACGTTGCTGTACTAG
TAGACGCAGGACGTAGTAG -> AGACGCAGGACGTAGTAGA
TGCGTATCCTAACTTTATC -> GCGTATCCTAACTTTATCA
CTTATGCCGTACCGCGAGC -> TTATGCCGTACCGCGAGCG
TGACCTAATCTGCCGTCGT -> GACCTAATCTGCCGTCGTC
CAGTTATCCGACGTTATCG -> AGTTATCCGACGTTATCGA
ATTTCTGAACTGCCGCTAG -> TTTCTGAACTGCCGCTAGG
ATGTCCTTCTTGACCTGTA -> TGTCCTTCTTGACCTGTAG
GTACCTAATCTGACCAATC -> TACCTAATCTGACCAATCT
CTTTAAATTAGCAGTGCAT -> TTTAAATTAGCAGTGCATT
GCTGGCGACGCAGGAGTAC -> CTGGCGACGCAGGAGTACC
AGCCACTAGTCTGTATATC -> GCCACTAGTCTGTATATCC
CACCTAATTCTGGGCTAAG -> ACCTAATTCTGGGCTAAGC
TAATTATGACCTAATCTGC -> AATTATGACCTAATCTGCC
GTGGAGCGCGGGTATCAAG -> TGGAGCGCGGGTATCAAGG
AAACAATAAGGGCCTTCAG -> AACAATAAGGGCCTTCAGC
CGACGCAGGAGTACCTTCA -> GACGCAGGAGTACCTTCAC
CACCTGTCGACCAGATGGG -> ACCTGTCGACCAGATGGGA
GCCAGCGAACGAAACCACG -> CCAGCGAACGAAACCACGA
GGCATGCGCCGAATCAACT -> GCATGCGCCGAATCAACTT
GTAACGGTCCGTGCATGGA -> TAACGGTCCGTGCATGGAG
GCCGTTGCTTTCCCGAGTT -> CCGTTGCTTTCCCGAGTTT
CTTTGGTTTGTGGCGAATC -> TTTGGTTTGTGGCGAATCG
GCGTGAACTCTATTACGAT -> CGTGAACTCTATTACGATA
GCTACCTATATCCGCGGCC -> CTACCTATATCCGCGGCCG
GTCTGTAACGGTCCGTGCA -> TCTGTAACGGTCCGTGCAT
TGTAGGGCTACGAGAGGGC -> GTAGGGCTACGAGAGGGCC
ATGGGATGCGTCACTTAGC -> TGGGATGCGTCACTTAGCC
CGTGGCGTGAACTCTATTA -> GTGGCGTGAACTCTATTAC
CATCTGCCCAGTGCAACAA -> ATCTGCCCAGTGCAACAAT
TTCTTGACCTGTAGAGCTA -> TCTTGACCTGTAGAGCTAC
CGATACCCTCGAATGCATT -> GATACCCTCGAATGCATTA
TTGAACATGGCCTTCAGCA -> TGAACATGGCCTTCAGCAG
GCTACCATAGTTTAGGGAC -> CTACCATAGTTTAGGGACC
AGCGGGTGCAACGTATCAT -> GCGGGTGCAACGTATCATT
AGGGTACCTCTCGTCTGGT -> GGGTACCTCTCGTCTGGTG
AGCGAACGAAACCACGATG -> GCGAACGAAACCACGATGG
GAATTAGGACACTCCTATT -> AATTAGGACACTCCTATTG
CATAGTTTAGGGACCCGTT -> ATAGTTTAGGGACCCGTTG
CTTTATGTTAGCACTTTAA -> TTTATGTTAGCACTTTAAA
GCAGAATTGCTCAAACGGG -> CAGAATTGCTCAAACGGGC
AGCGCGGGTATCAAGGAGC -> GCGCGGGTATCAAGGAGCC
GCGCAGAGGGCGCCCCAAC -> CGCAGAGGGCGCCCCAACG
TGCGCAGAGGGCGCCCCAA -> GCGCAGAGGGCGCCCCAAC
AAGTGTACCAGTTGTTTAT -> AGTGTACCAGTTGTTTATG
TATGACTAATTTGAATACT -> ATGACTAATTTGAATACTC
TGTGGACAGGAATAGTGAC -> GTGGACAGGAATAGTGACG
AGAAGCCGCAGAGCCCGTT -> GAAGCCGCAGAGCCCGTTT
GAACTGACTACACATTTCT -> AACTGACTACACATTTCTG
CGCTGGCGACGCAGGAGTA -> GCTGGCGACGCAGGAGTAC
TTGACGACCGAACTGACTA -> TGACGACCGAACTGACTAC
TTGTCTCCACAGCAATTTG -> TGTCTCCACAGCAATTTGG
TCGATTGCGCAGAGGGCGC -> CGATTGCGCAGAGGGCGCC
TCATATGCGATCAAAGTGC -> CATATGCGATCAAAGTGCG
TCTCCACAGCAATTTGGAA -> CTCCACAGCAATTTGGAAG
GTAATTATGACCTAATCTG -> TAATTATGACCTAATCTGC
TGTGATAGCTAATAACGGT -> GTGATAGCTAATAACGGTA
GTCAGTCTTGAGATGATAC -> TCAGTCTTGAGATGATACC
TTTCCCGAGTTTTTTGTAC -> TTCCCGAGTTTTTTGTACG
CGATCCGGACGAGTTGGCA -> GATCCGGACGAGTTGGCAT
TCGGCTTAAGTAATATAAG -> CGGCTTAAGTAATATAAGT
CGTGTGCACCTGTAATTAT -> GTGTGCACCTGTAATTATG
ACGAGTTGGCATGCGCCGA -> CGAGTTGGCATGCGCCGAA
GTGAACTCTATTACGATAG -> TGAACTCTATTACGATAGG
TTTGAACATGGCCTTCAGC -> TTGAACATGGCCTTCAGCA
GGCTAAGCCTTGGACCACT -> GCTAAGCCTTGGACCACTT
AATACTACGGATTGGAGAA -> ATACTACGGATTGGAGAAC
CAAGCAGAATTGCTCAAAC -> AAGCAGAATTGCTCAAACG
TTGAGCACGCAGGGTCCTG -> TGAGCACGCAGGGTCCTGT
CGTACCGCGAGCGGGTGCA -> GTACCGCGAGCGGGTGCAA
TGTAACGGTCCGTGCATGG -> GTAACGGTCCGTGCATGGA
TTTGCCCCACGTAACCTTG -> TTGCCCCACGTAACCTTGG
TCGACAAATTTGTGTACCA -> CGACAAATTTGTGTACCAT
CGGCTCGCGTGTGCACCTG -> GGCTCGCGTGTGCACCTGT
TACCTTCACGCGATCCGGT -> ACCTTCACGCGATCCGGTC
ATCGAGAGGACATGTCCAA -> TCGAGAGGACATGTCCAAG
CTTACCTAAACCAGAAAAC -> TTACCTAAACCAGAAAACA
TCGGGAGTACATTTAAACA -> CGGGAGTACATTTAAACAA
ACGGTCCGTGCATGGAGTA -> CGGTCCGTGCATGGAGTAT
TAATTCAGAGTGCGAATAC -> AATTCAGAGTGCGAATACG
GTGCGTATCCTAACTTTAT -> TGCGTATCCTAACTTTATC
GGATTTTACCCTCCTAAGG -> GATTTTACCCTCCTAAGGT
ACGCTACGAAGCTGATCGA -> CGCTACGAAGCTGATCGAG
ACCCACTTTGCCTTGTGCG -> CCCACTTTGCCTTGTGCGT
ACAATAATTCAGAGTGCGA -> CAATAATTCAGAGTGCGAA
ATCTGCCGTCGTCCGATAC -> TCTGCCGTCGTCCGATACC
GGACACTCCTATTGTCTCC -> GACACTCCTATTGTCTCCA
TATCATATGCGATCAAAGT -> ATCATATGCGATCAAAGTG
GATGGAGTAATGGAGTTAT -> ATGGAGTAATGGAGTTATA
AGGCGCCTCGATCAAAACT -> GGCGCCTCGATCAAAACTC
AACACCGTACCGCGAGCGG -> ACACCGTACCGCGAGCGGG
GTAGTAGAAGCCGCAGAGC -> TAGTAGAAGCCGCAGAGCC
GATCGAGAGGACATGTCCA -> ATCGAGAGGACATGTCCAA
CCTGGCGGACCCCCAACGA -> CTGGCGGACCCCCAACGAT
TAGAAGCCGCAGAGCCCGT -> AGAAGCCGCAGAGCCCGTT
GTTTAGGGACCCGTTGAGT -> TTTAGGGACCCGTTGAGTT
TTTGTACGGAACCTCGGTC -> TTGTACGGAACCTCGGTCT
AAGCTCACCCACGAAATCC -> AGCTCACCCACGAAATCCA
CGGGCGGTCGGTCCATTCG -> GGGCGGTCGGTCCATTCGA
AATGACTATGGCTAATGCT -> ATGACTATGGCTAATGCTT
GCGAGCGGGTGCAACGTAT -> CGAGCGGGTGCAACGTATC
CCACTAGTCTGTATTGCTT -> CACTAGTCTGTATTGCTTT
TATATCCGCGGCCGATCCG -> ATATCCGCGGCCGATCCGG
CTCCTGACTGCTATCGGAG -> TCCTGACTGCTATCGGAGG
ACAAACCCTCTCCTCCTGT -> CAAACCCTCTCCTCCTGTA
CTCGCGTGTGCACCTGTAA -> TCGCGTGTGCACCTGTAAT
GTTCGTTGTCCTCAACTCC -> TTCGTTGTCCTCAACTCCG
ATGACTATGGCTAATGCTT -> TGACTATGGCTAATGCTTT
ATAGCCGCTTACCTAAACC -> TAGCCGCTTACCTAAACCA
GCGGTCGGTCCATTCGAAT -> CGGTCGGTCCATTCGAATG
TTCGAATGCTGCACCCGAT -> TCGAATGCTGCACCCGATA
CTCTTGAGCACGCAGGGTC -> TCTTGAGCACGCAGGGTCC
TCAAACGGGCTCCAACTCC -> CAAACGGGCTCCAACTCCG
CCCGATAGAGCCACAAACA -> CCGATAGAGCCACAAACAA
CGCGTGTGCACCTGTAATT -> GCGTGTGCACCTGTAATTA
TAATGGAGTTATATTATGG -> AATGGAGTTATATTATGGA
TCCTGTGGACAGGAATAGT -> CCTGTGGACAGGAATAGTG
AGCCCTGGCGGACCCCCAA -> GCCCTGGCGGACCCCCAAC
TCCGTACGAATCACTGCTA -> CCGTACGAATCACTGCTAC
CTGGGCTAAGCCTTGGACC -> TGGGCTAAGCCTTGGACCA
TCTTGCCCACGTCCATCCA -> CTTGCCCACGTCCATCCAC
GCATGCATCTTTTAAGGCG -> CATGCATCTTTTAAGGCGC
GGCGACGCAGGAGTACCTT -> GCGACGCAGGAGTACCTTC
TTAGCCCACCGGCAGGGTA -> TAGCCCACCGGCAGGGTAC
GAGTTTTTTGTACGGAACC -> AGTTTTTTGTACGGAACCT
GGATTGGAGAACCAGGCGC -> GATTGGAGAACCAGGCGCT
GAAATGTTAAGGTCAGTCT -> AAATGTTAAGGTCAGTCTT
ACTTTATCATATGCGATCA -> CTTTATCATATGCGATCAA
ATATACGGTTGGCACGGTC -> TATACGGTTGGCACGGTCA
TAGATCGGCTTAAGTAATA -> AGATCGGCTTAAGTAATAT
ATCCACTTGCTACCATAGT -> TCCACTTGCTACCATAGTT
ATGCCGTACCGCGAGCGGG -> TGCCGTACCGCGAGCGGGT
TACATTTACCATCAAGGAG -> ACATTTACCATCAAGGAGC
CAATACTACGGATTGGAGA -> AATACTACGGATTGGAGAA
CGACTGATGAGGGTTAATC -> GACTGATGAGGGTTAATCT
GGAGCCACTAGTCTGTATT -> GAGCCACTAGTCTGTATTG
GCTAAGCCTTGGACCACTT -> CTAAGCCTTGGACCACTTC
AGCACTGACGACGTAGTTT -> GCACTGACGACGTAGTTTG
CCGTTGAGTTCCATTCCAC -> CGTTGAGTTCCATTCCACT
GCGATCAAAGTGCGTTCGG -> CGATCAAAGTGCGTTCGGG
TCCAAGCAGAATTGCTCAA -> CCAAGCAGAATTGCTCAAA
AGTGCCCATTTGTATTTAA -> GTGCCCATTTGTATTTAAA
CCACCGCCATTGTGATAGC -> CACCGCCATTGTGATAGCT
CCTCAACTCCGTGGCGTGA -> CTCAACTCCGTGGCGTGAA
CCGCGAGCGGGTGACGGCT -> CGCGAGCGGGTGACGGCTG
CACGGTCATGGGACAGTCC -> ACGGTCATGGGACAGTCCT
CACGATGGAGTAATGGAGT -> ACGATGGAGTAATGGAGTT
TGCATTGGATTACGGCATT -> GCATTGGATTACGGCATTA
CTTCAAAGGATGCTAAGAT -> TTCAAAGGATGCTAAGATA
GATCCGGACGAGTTGGCAT -> ATCCGGACGAGTTGGCATG
GACAGGAATAGTGACGCTG -> ACAGGAATAGTGACGCTGA
CAATGACTATGGCTAATGC -> AATGACTATGGCTAATGCT
CGCGAGCGGGTGGAGCGCG -> GCGAGCGGGTGGAGCGCGG
GATAGAGCCACAAACAAAC -> ATAGAGCCACAAACAAACG
CACATTTCTGAACTGCCGC -> ACATTTCTGAACTGCCGCT
GTGCATTGGATTACGGCAT -> TGCATTGGATTACGGCATT
GAAAACAATACTACGGATT -> AAAACAATACTACGGATTG
AGATGATACCGCATGCATC -> GATGATACCGCATGCATCT
GCGGGTATCAAGGAGCCAC -> CGGGTATCAAGGAGCCACT
CCACTTTGCCTTGTGCGTA -> CACTTTGCCTTGTGCGTAT
CGGGTGACGGCTGCAATTC -> GGGTGACGGCTGCAATTCA
ATTGCTCAAACGGGCTCCA -> TTGCTCAAACGGGCTCCAA
GAATGCATTACAGAGCTCG -> AATGCATTACAGAGCTCGT
TCCGGTCTGGGAGCGAAGC -> CCGGTCTGGGAGCGAAGCA
AACGGGCTCCAACTCCGTA -> ACGGGCTCCAACTCCGTAC
GTCTCCACAGCAATTTGGA -> TCTCCACAGCAATTTGGAA
TCTGGTGACTTATGCCGTA -> CTGGTGACTTATGCCGTAC
CCTATATCCGCGGCCGATC -> CTATATCCGCGGCCGATCC
GCTACGAAGCTGATCGAGA -> CTACGAAGCTGATCGAGAG
CCGCAGAGCCCGTTTGCCT -> CGCAGAGCCCGTTTGCCTG
AACCTTACAGTTATCCGAC -> ACCTTACAGTTATCCGACG
CTGGCGGACCCCCAACGAT -> TGGCGGACCCCCAACGATG
GAAACCACGATGGAGTAAT -> AAACCACGATGGAGTAATG
CACCGCCATTGTGATAGCT -> ACCGCCATTGTGATAGCTA
CACCGTACCGCGAGCGGGT -> ACCGTACCGCGAGCGGGTG
TGAGCACGCAGGGTCCTGT -> GAGCACGCAGGGTCCTGTG
CCTCTCCTCCTGTACTGGG -> CTCTCCTCCTGTACTGGGT
ACTCCTGACTGCTATCGGA -> CTCCTGACTGCTATCGGAG
CTTCGAGCTTCAAAGGATG -> TTCGAGCTTCAAAGGATGC
TATCGACTGATGAGGGTTA -> ATCGACTGATGAGGGTTAA
CTCAACTCCGTGGCGTGAA -> TCAACTCCGTGGCGTGAAC
AGTCCTAATGTAGACGCAG -> GTCCTAATGTAGACGCAGG
TATATCGACTGATGAGGGT -> ATATCGACTGATGAGGGTT
GAGTGCGAATACGCGCAAC -> AGTGCGAATACGCGCAACA
ACCATCAAGGAGCCACTAG -> CCATCAAGGAGCCACTAGT
TGCCGTCGTCCGATACCCT -> GCCGTCGTCCGATACCCTC
CCAATCTAATTAGCCCGGC -> CAATCTAATTAGCCCGGCT
CGATGGATTCCACCGAACC -> GATGGATTCCACCGAACCC
AAATTTGTGTACCATAGAT -> AATTTGTGTACCATAGATC
CGCTTTGAACATGGCCTTC -> GCTTTGAACATGGCCTTCA
CTGGATTTTACCCTCCTAA -> TGGATTTTACCCTCCTAAG
TCTACCGAACAGATTTCCT -> CTACCGAACAGATTTCCTT
AAGCACTGACGACGTAGTT -> AGCACTGACGACGTAGTTT
TATCCGTCGGGAGTACATT -> ATCCGTCGGGAGTACATTT
AACGCCCGGTCGGATATAC -> ACGCCCGGTCGGATATACG
ATAAGGGCCTTCAGCAGCC -> TAAGGGCCTTCAGCAGCCA
TTAGCAGTGCATTGGATTA -> TAGCAGTGCATTGGATTAC
ACCAGAAAACAATACTACG -> CCAGAAAACAATACTACGG
CCACTAGTCTGACCTCTTG -> CACTAGTCTGACCTCTTGA
GATCGTAGAGGGTAGTATA -> ATCGTAGAGGGTAGTATAG
TCGAATGCTGCACCCGATA -> CGAATGCTGCACCCGATAG
GTATATCCGTCGGGAGTAC -> TATATCCGTCGGGAGTACA
GGATGCTAAGATAAGCTCA -> GATGCTAAGATAAGCTCAC
TCGTTTCTACCGAACAGAT -> CGTTTCTACCGAACAGATT
ACCTCTTGAGCACGCAGGG -> CCTCTTGAGCACGCAGGGT
AGTCTGTATATCCGTCGGG -> GTCTGTATATCCGTCGGGA
AGCAGAACGCCCGGTCGGA -> GCAGAACGCCCGGTCGGAT
GAACATGGCCTTCAGCAGA -> AACATGGCCTTCAGCAGAA
TTCGTTGTCCTCAACTCCG -> TCGTTGTCCTCAACTCCGT
AGCGGGTGTACATTTACCA -> GCGGGTGTACATTTACCAT
TTAGGACACTCCTATTGTC -> TAGGACACTCCTATTGTCT
GATAGCTCGTATACTTTCA -> ATAGCTCGTATACTTTCAA
GGATTTAATAGCAAGGGAT -> GATTTAATAGCAAGGGATC
GTCATGGGACAGTCCTAAT -> TCATGGGACAGTCCTAATG
ATTAGCAGTGCATTGGATT -> TTAGCAGTGCATTGGATTA
ACCACACCTAATGCAGCCG -> CCACACCTAATGCAGCCGC
TAGTTTAGGGACCCGTTGA -> AGTTTAGGGACCCGTTGAG
AGTATAGCCCTGGCGGACC -> GTATAGCCCTGGCGGACCC
CAAAACTCGCCGAAGACGC -> AAAACTCGCCGAAGACGCT
CGACGTAGTTTGACGACCG -> GACGTAGTTTGACGACCGA
CTCGCTTAGCGATGAATCC -> TCGCTTAGCGATGAATCCT
TCGCCTTCGTTTCTACCGA -> CGCCTTCGTTTCTACCGAA
ATGCATCTTTTAAGGCGCC -> TGCATCTTTTAAGGCGCCT
CTGCACCCGATAGAGCCAC -> TGCACCCGATAGAGCCACA
CGATGAATCCTGTAACAAA -> GATGAATCCTGTAACAAAC
GCTACAACAACTCCTGACT -> CTACAACAACTCCTGACTG
ACCAGTTGTTTATGTTTTC -> CCAGTTGTTTATGTTTTCC
ACTGCTACAACAACTCCTG -> CTGCTACAACAACTCCTGA
GCGGGTGCAACGTATCATT -> CGGGTGCAACGTATCATTC
TTGACCTGTAGAGCTACCT -> TGACCTGTAGAGCTACCTA
GTCTGTATATCCGTCGGGA -> TCTGTATATCCGTCGGGAG
TCCTGTACTGGGTAACCCA -> CCTGTACTGGGTAACCCAT
AGTTATGACTAATTTGAAT -> GTTATGACTAATTTGAATA
GTCGAATTCGATTGCGCAG -> TCGAATTCGATTGCGCAGA
TGTACCATAGATCGGCTTA -> GTACCATAGATCGGCTTAA
ACTCCTATTGTCTCCACAG -> CTCCTATTGTCTCCACAGC
AGCAGTGCATTGGATTACG -> GCAGTGCATTGGATTACGG
TACGGAACCTCGGTCTCTT -> ACGGAACCTCGGTCTCTTT
ATTAGGACACTCCTATTGT -> TTAGGACACTCCTATTGTC
CCTCGGTCTCTTTATGTTA -> CTCGGTCTCTTTATGTTAG
TATGACCTAATCTGCCGTC -> ATGACCTAATCTGCCGTCG
TCCTGTAACAAACCCTCTC -> CCTGTAACAAACCCTCTCC
GTATCATTCAAGGAGCCAC -> TATCATTCAAGGAGCCACT
TTACCCTCCTAAGGTCATA -> TACCCTCCTAAGGTCATAG
GCACCTGTCGACCAGATGG -> CACCTGTCGACCAGATGGG
CGTTCGGGCCTCCCAATGA -> GTTCGGGCCTCCCAATGAC
GTATTGCTTTGGTTTGTGG -> TATTGCTTTGGTTTGTGGC
ATACTTTCAACACCGTACC -> TACTTTCAACACCGTACCG
ATGCATTACAGAGCTCGTA -> TGCATTACAGAGCTCGTAG
CAGTCGAATTCGATTGCGC -> AGTCGAATTCGATTGCGCA
GCTTTCTTGCCCACGTCCA -> CTTTCTTGCCCACGTCCAT
TGCGTCACTTAGCCCACCG -> GCGTCACTTAGCCCACCGG
CACTTGCTACCATAGTTTA -> ACTTGCTACCATAGTTTAG
TTGAATACTCCCCAAATTA -> TGAATACTCCCCAAATTAA
CATTCCACTTCGCCTTCGT -> ATTCCACTTCGCCTTCGTT
GGACAGTCCTAATGTAGAC -> GACAGTCCTAATGTAGACG
GGAGTTATATTATGGAATT -> GAGTTATATTATGGAATTA
TCCATTCGAATGCTGCACC -> CCATTCGAATGCTGCACCC
TGCAATTCAAGGAGCCACT -> GCAATTCAAGGAGCCACTA
GCGGGTGGAGCGCGGGTAT -> CGGGTGGAGCGCGGGTATC
TAGACCACCTAATTCTGGG -> AGACCACCTAATTCTGGGC
GTCCGTGCATGGAGTATAG -> TCCGTGCATGGAGTATAGC
AATTGCTCAAACGGGCTCC -> ATTGCTCAAACGGGCTCCA
AGATCGTAGAGGGTAGTAT -> GATCGTAGAGGGTAGTATA
TAACTTTATCATATGCGAT -> AACTTTATCATATGCGATC
TGGAGAACCAGGCGCTTTG -> GGAGAACCAGGCGCTTTGA
AATTCAAGGAGCCACTAGT -> ATTCAAGGAGCCACTAGTC
TATGCCGTACCGCGAGCGG -> ATGCCGTACCGCGAGCGGG
TTAATACCGGAACCTTACA -> TAATACCGGAACCTTACAG
TGTATTGCTTTGGTTTGTG -> GTATTGCTTTGGTTTGTGG
GCCTTCGAGCTTCAAAGGA -> CCTTCGAGCTTCAAAGGAT
TGTTAGCACTTTAAATTAG -> GTTAGCACTTTAAATTAGC
ATGCTTTCTTGCCCACGTC -> TGCTTTCTTGCCCACGTCC
AGGACGTAGTAGAAGCCGC -> GGACGTAGTAGAAGCCGCA
TAGCTAATAACGGTAACCG -> AGCTAATAACGGTAACCGT
GATCGTAGACCACCTAATT -> ATCGTAGACCACCTAATTC
CATCCACTTGCTACCATAG -> ATCCACTTGCTACCATAGT
TTTATCATATGCGATCAAA -> TTATCATATGCGATCAAAG
AACCTTGGTAAGTGTACCA -> ACCTTGGTAAGTGTACCAG
TATGTTTTCCTACCAAGAT -> ATGTTTTCCTACCAAGATA
GGCAGGGTACCTCTCGTCT -> GCAGGGTACCTCTCGTCTG
TTTATGTTAGCACTTTAAA -> TTATGTTAGCACTTTAAAT
ACACTCCTATTGTCTCCAC -> CACTCCTATTGTCTCCACA
TGAACTGCCGCTAGGATGT -> GAACTGCCGCTAGGATGTC
TACCGAACAGATTTCCTTT -> ACCGAACAGATTTCCTTTA
TGCCCATTTGTATTTAAAG -> GCCCATTTGTATTTAAAGA
GTTTGCCTGGATTTTACCC -> TTTGCCTGGATTTTACCCT
TAATAACGGTAACCGTTCG -> AATAACGGTAACCGTTCGT
CGGGATTTAATAGCAAGGG -> GGGATTTAATAGCAAGGGA
CTGCCGTCGTCCGATACCC -> TGCCGTCGTCCGATACCCT
GGCACGGTCATGGGACAGT -> GCACGGTCATGGGACAGTC
TTTCCTTTAGCTGATGTAG -> TTCCTTTAGCTGATGTAGG
TACCTATATCCGCGGCCGA -> ACCTATATCCGCGGCCGAT
CCGTACGAATCACTGCTAC -> CGTACGAATCACTGCTACA
GTTAGCACTTTAAATTAGC -> TTAGCACTTTAAATTAGCA
TTCTGGGCTAAGCCTTGGA -> TCTGGGCTAAGCCTTGGAC
CAACACCGTACCGCGAGCG -> AACACCGTACCGCGAGCGG
GGTCCTGTGGACAGGAATA -> GTCCTGTGGACAGGAATAG
CACCTAATGCAGCCGCCGA -> ACCTAATGCAGCCGCCGAC
ACCATAGTTTAGGGACCCG -> CCATAGTTTAGGGACCCGT
CATGGGACAGTCCTAATGT -> ATGGGACAGTCCTAATGTA
CATTGGATTACGGCATTAT -> ATTGGATTACGGCATTATA
AAGATCGTAGAGGGTAGTA -> AGATCGTAGAGGGTAGTAT
AGGATGTCCTTCTTGACCT -> GGATGTCCTTCTTGACCTG
TTTATGTTTTCCTACCAAG -> TTATGTTTTCCTACCAAGA
GTTCGGGCCTCCCAATGAC -> TTCGGGCCTCCCAATGACT
AGAGGGCCGCCGCATCTGC -> GAGGGCCGCCGCATCTGCC
GCTATTCAATCTTGACTCA -> CTATTCAATCTTGACTCAA
AGGGCCGCCGCATCTGCCC -> GGGCCGCCGCATCTGCCCA
TTTACCCTCCTAAGGTCAT -> TTACCCTCCTAAGGTCATA
GCGGGTGACGGCTGCAATT -> CGGGTGACGGCTGCAATTC
AGGTGCTAGTTATGACTAA -> GGTGCTAGTTATGACTAAT
GCGAAGCACTGACGACGTA -> CGAAGCACTGACGACGTAG
GCTTACCTAAACCAGAAAA -> CTTACCTAAACCAGAAAAC
GACGACGTAGTTTGACGAC -> ACGACGTAGTTTGACGACC
TTGCTGTACTAGGAGTACC -> TGCTGTACTAGGAGTACCT
AACCCGTACCGCGAGCGGG -> ACCCGTACCGCGAGCGGGT
TCGCTTAGCGATGAATCCT -> CGCTTAGCGATGAATCCTG
ACTTTCAACACCGTACCGC -> CTTTCAACACCGTACCGCG
CAGGGTACCTCTCGTCTGG -> AGGGTACCTCTCGTCTGGT
CGCCCGGTCGGATATACGG -> GCCCGGTCGGATATACGGT
ATCGTAGACCACCTAATTC -> TCGTAGACCACCTAATTCT
GTAACAAACCCTCTCCTCC -> TAACAAACCCTCTCCTCCT
GCATGCGCCGAATCAACTT -> CATGCGCCGAATCAACTTC
CCGCGAGCGGGTGGAGCGC -> CGCGAGCGGGTGGAGCGCG
CCTCCTGTACTGGGTAACC -> CTCCTGTACTGGGTAACCC
CTAACTTTATCATATGCGA -> TAACTTTATCATATGCGAT
GTTCGGGCGGTCGGTCCAT -> TTCGGGCGGTCGGTCCATT
TCCCCAAATTAATACCGGA -> CCCCAAATTAATACCGGAA
AGCAGAATTGCTCAAACGG -> GCAGAATTGCTCAAACGGG
ATCGAAGCCGGGATTTAAT -> TCGAAGCCGGGATTTAATA
GAAGCTGATCGAGAGGACA -> AAGCTGATCGAGAGGACAT
CGGCTGCAATTCAAGGAGC -> GGCTGCAATTCAAGGAGCC
GACTCAATCTCAGTCGAAT -> ACTCAATCTCAGTCGAATT
TAAAGATCGTAGAGGGTAG -> AAAGATCGTAGAGGGTAGT
TTATCATATGCGATCAAAG -> TATCATATGCGATCAAAGT
AACACGTTGCTGTACTAGG -> ACACGTTGCTGTACTAGGA
ACCTAATTCTGGGCTAAGC -> CCTAATTCTGGGCTAAGCC
CAGTGCATTGGATTACGGC -> AGTGCATTGGATTACGGCA
AATCCTGTAACAAACCCTC -> ATCCTGTAACAAACCCTCT
CTACGAGAGGGCCGCCGCA -> TACGAGAGGGCCGCCGCAT
AAGGGATCGTAGACCACCT -> AGGGATCGTAGACCACCTA
GCAATTTGGAAGCCTTCGA -> CAATTTGGAAGCCTTCGAG
TGCACCTGTAATTATGACC -> GCACCTGTAATTATGACCT
GCAGAGCCCGTTTGCCTGG -> CAGAGCCCGTTTGCCTGGA
CATCTTTTAAGGCGCCTCG -> ATCTTTTAAGGCGCCTCGA
ACATTTCTGAACTGCCGCT -> CATTTCTGAACTGCCGCTA
CAATCTAATTAGCCCGGCT -> AATCTAATTAGCCCGGCTC
CAGAAAACAATACTACGGA -> AGAAAACAATACTACGGAT
CGAATTCGATTGCGCAGAG -> GAATTCGATTGCGCAGAGG
GGCGGACCCCCAACGATGG -> GCGGACCCCCAACGATGGA
ACTTCAGGGACTTTATATC -> CTTCAGGGACTTTATATCG
CCTGTAATTATGACCTAAT -> CTGTAATTATGACCTAATC
AGCCTTGGACCACTTCCGT -> GCCTTGGACCACTTCCGTA
CGCATCTGCCCAGTGCAAC -> GCATCTGCCCAGTGCAACA
CAACACGTTGCTGTACTAG -> AACACGTTGCTGTACTAGG
TGGCATGCGCCGAATCAAC -> GGCATGCGCCGAATCAACT
TCACGCGATCCGGTCTGGG -> CACGCGATCCGGTCTGGGA
GAGGGCCGCCGCATCTGCC -> AGGGCCGCCGCATCTGCCC
CTTGTGCGTATCCTAACTT -> TTGTGCGTATCCTAACTTT
CTAGGATGTCCTTCTTGAC -> TAGGATGTCCTTCTTGACC
TGTTTTCCTACCAAGATAG -> GTTTTCCTACCAAGATAGC
CCGCCGACCACCGTGGCTG -> CGCCGACCACCGTGGCTGC
AACAACTCCTGACTGCTAT -> ACAACTCCTGACTGCTATC
AGGGCTACGAGAGGGCCGC -> GGGCTACGAGAGGGCCGCC
GGAACCTCGGTCTCTTTAT -> GAACCTCGGTCTCTTTATG
AATAAGGGCCTTCAGCAGC -> ATAAGGGCCTTCAGCAGCC
CCGTTTGCCTGGATTTTAC -> CGTTTGCCTGGATTTTACC
ACGATGGAGTAATGGAGTT -> CGATGGAGTAATGGAGTTA
AATTCTGGGCTAAGCCTTG -> ATTCTGGGCTAAGCCTTGG
